fips,state,county,labor_force,employed,unemployed,unemp_rate
1001,AL,Autauga,25966,24645,1321,5.1
1003,AL,Baldwin,90670,85839,4831,5.3
1005,AL,Barbour,8417,7717,700,8.3
1007,AL,Bibb,8623,8067,556,6.4
1009,AL,Blount,24623,23298,1325,5.4
1011,AL,Bullock,4833,4503,330,6.8
1013,AL,Butler,9206,8571,635,6.9
1015,AL,Calhoun,45902,42906,2996,6.5
1017,AL,Chambers,15006,14188,818,5.5
1019,AL,Cherokee,11353,10780,573,5
1021,AL,Chilton,19219,18167,1052,5.5
1023,AL,Choctaw,4334,3966,368,8.5
1025,AL,Clarke,7966,7102,864,10.8
1027,AL,Clay,5634,5300,334,5.9
1029,AL,Cleburne,5796,5450,346,6
1031,AL,Coffee,20633,19424,1209,5.9
1033,AL,Colbert,23491,21862,1629,6.9
1035,AL,Conecuh,4556,4173,383,8.4
1037,AL,Coosa,4387,4126,261,5.9
1039,AL,Covington,15519,14472,1047,6.7
1041,AL,Crenshaw,6463,6085,378,5.8
1043,AL,Cullman,37971,36087,1884,5
1045,AL,Dale,19993,18839,1154,5.8
1047,AL,Dallas,15443,14023,1420,9.2
1049,AL,DeKalb,29283,27511,1772,6.1
1051,AL,Elmore,37292,35521,1771,4.7
1053,AL,Escambia,14577,13611,966,6.6
1055,AL,Etowah,43345,40787,2558,5.9
1057,AL,Fayette,6607,6163,444,6.7
1059,AL,Franklin,13889,13074,815,5.9
1061,AL,Geneva,10825,10200,625,5.8
1063,AL,Greene,2876,2591,285,9.9
1065,AL,Hale,5991,5534,457,7.6
1067,AL,Henry,6733,6295,438,6.5
1069,AL,Houston,44624,42048,2576,5.8
1071,AL,Jackson,23623,22136,1487,6.3
1073,AL,Jefferson,311710,293873,17837,5.7
1075,AL,Lamar,5699,5379,320,5.6
1077,AL,Lauderdale,42599,39895,2704,6.3
1079,AL,Lawrence,13742,12795,947,6.9
1081,AL,Lee,72474,68690,3784,5.2
1083,AL,Limestone,40753,38621,2132,5.2
1085,AL,Lowndes,3806,3405,401,10.5
1087,AL,Macon,7881,7282,599,7.6
1089,AL,Madison,173846,164964,8882,5.1
1091,AL,Marengo,7684,7136,548,7.1
1093,AL,Marion,12517,11690,827,6.6
1095,AL,Marshall,41652,39434,2218,5.3
1097,AL,Mobile,188082,175642,12440,6.6
1099,AL,Monroe,7326,6664,662,9
1101,AL,Montgomery,105928,99944,5984,5.6
1103,AL,Morgan,54957,51923,3034,5.5
1105,AL,Perry,3472,3115,357,10.3
1107,AL,Pickens,7779,7246,533,6.9
1109,AL,Pike,14973,14002,971,6.5
1111,AL,Randolph,9444,8918,526,5.6
1113,AL,Russell,23571,22264,1307,5.5
1115,AL,St. Clair,39145,37122,2023,5.2
1117,AL,Shelby,109762,105053,4709,4.3
1119,AL,Sumter,5119,4726,393,7.7
1121,AL,Talladega,34872,32576,2296,6.6
1123,AL,Tallapoosa,18611,17575,1036,5.6
1125,AL,Tuscaloosa,99416,93818,5598,5.6
1127,AL,Walker,25607,23706,1901,7.4
1129,AL,Washington,6752,6172,580,8.6
1131,AL,Wilcox,2822,2416,406,14.4
1133,AL,Winston,9548,8872,676,7.1
2013,AK,Aleutians East Borough,2587,2517,70,2.7
2016,AK,Aleutians West Census Area,3978,3846,132,3.3
2020,AK,Anchorage Borough/municipality,155461,146890,8571,5.5
2050,AK,Bethel Census Area,7246,6214,1032,14.2
2060,AK,Bristol Bay Borough,413,384,29,7
2068,AK,Denali Borough,1094,995,99,9
2070,AK,Dillingham Census Area,2077,1877,200,9.6
2090,AK,Fairbanks North Star Borough,46449,43717,2732,5.9
2100,AK,Haines Borough,1074,964,110,10.2
2105,AK,Hoonah-Angoon Census Area,1205,1062,143,11.9
2110,AK,Juneau Borough/city,17338,16559,779,4.5
2122,AK,Kenai Peninsula Borough,27161,24847,2314,8.5
2130,AK,Ketchikan Gateway Borough,7026,6566,460,6.5
2150,AK,Kodiak Island Borough,6416,6086,330,5.1
2158,AK,Kusilvak Census Area,2725,2136,589,21.6
2164,AK,Lake and Peninsula Borough,655,573,82,12.5
2170,AK,Matanuska-Susitna Borough,47408,43505,3903,8.2
2180,AK,Nome Census Area,4084,3565,519,12.7
2185,AK,North Slope Borough,3953,3685,268,6.8
2188,AK,Northwest Arctic Borough,2964,2490,474,16
2195,AK,Petersburg Borough,1450,1319,131,9
2198,AK,Prince of Wales-Hyder Census Area,2768,2431,337,12.2
2220,AK,Sitka Borough/city,4371,4169,202,4.6
2230,AK,Skagway Municipality,805,715,90,11.2
2240,AK,Southeast Fairbanks Census Area,2996,2674,322,10.7
2261,AK,Valdez-Cordova Census Area,4810,4396,414,8.6
2275,AK,Wrangell Borough/city,1055,975,80,7.6
2282,AK,Yakutat Borough/city,243,223,20,8.2
2290,AK,Yukon-Koyukuk Census Area,2423,1990,433,17.9
4001,AZ,Apache,20320,17984,2336,11.5
4003,AZ,Cochise,49597,46498,3099,6.2
4005,AZ,Coconino,74181,69706,4475,6
4007,AZ,Gila,20996,19474,1522,7.2
4009,AZ,Graham,14373,13402,971,6.8
4011,AZ,Greenlee,3900,3604,296,7.6
4012,AZ,La Paz,8470,7957,513,6.1
4013,AZ,Maricopa,2080523,1985001,95522,4.6
4015,AZ,Mohave,80509,75168,5341,6.6
4017,AZ,Navajo,41330,37908,3422,8.3
4019,AZ,Pima,469613,446263,23350,5
4021,AZ,Pinal,163946,154832,9114,5.6
4023,AZ,Santa Cruz,19192,17261,1931,10.1
4025,AZ,Yavapai,99526,94609,4917,4.9
4027,AZ,Yuma,94117,76345,17772,18.9
5001,AR,Arkansas,9267,8952,315,3.4
5003,AR,Ashley,7735,7249,486,6.3
5005,AR,Baxter,16098,15408,690,4.3
5007,AR,Benton,127925,124210,3715,2.9
5009,AR,Boone,15930,15346,584,3.7
5011,AR,Bradley,4292,4067,225,5.2
5013,AR,Calhoun,2377,2268,109,4.6
5015,AR,Carroll,12871,12414,457,3.6
5017,AR,Chicot,3582,3347,235,6.6
5019,AR,Clark,9384,8970,414,4.4
5021,AR,Clay,6037,5697,340,5.6
5023,AR,Cleburne,9474,8912,562,5.9
5025,AR,Cleveland,3343,3193,150,4.5
5027,AR,Columbia,9267,8738,529,5.7
5029,AR,Conway,8444,7962,482,5.7
5031,AR,Craighead,52230,50539,1691,3.2
5033,AR,Crawford,26949,25902,1047,3.9
5035,AR,Crittenden,21608,20634,974,4.5
5037,AR,Cross,7882,7534,348,4.4
5039,AR,Dallas,2884,2739,145,5
5041,AR,Desha,5441,5145,296,5.4
5043,AR,Drew,7809,7357,452,5.8
5045,AR,Faulkner,60553,58259,2294,3.8
5047,AR,Franklin,7362,7066,296,4
5049,AR,Fulton,4666,4464,202,4.3
5051,AR,Garland,40084,38363,1721,4.3
5053,AR,Grant,8275,7977,298,3.6
5055,AR,Greene,19799,18953,846,4.3
5057,AR,Hempstead,9928,9554,374,3.8
5059,AR,Hot Spring,14069,13516,553,3.9
5061,AR,Howard,5950,5755,195,3.3
5063,AR,Independence,16006,15215,791,4.9
5065,AR,Izard,4964,4686,278,5.6
5067,AR,Jackson,6057,5680,377,6.2
5069,AR,Jefferson,28323,26739,1584,5.6
5071,AR,Johnson,10526,10028,498,4.7
5073,AR,Lafayette,2547,2397,150,5.9
5075,AR,Lawrence,6917,6618,299,4.3
5077,AR,Lee,3091,2946,145,4.7
5079,AR,Lincoln,4095,3898,197,4.8
5081,AR,Little River,5592,5331,261,4.7
5083,AR,Logan,9121,8703,418,4.6
5085,AR,Lonoke,33387,32279,1108,3.3
5087,AR,Madison,7286,7053,233,3.2
5089,AR,Marion,6521,6261,260,4
5091,AR,Miller,19869,19038,831,4.2
5093,AR,Mississippi,18066,16844,1222,6.8
5095,AR,Monroe,2879,2741,138,4.8
5097,AR,Montgomery,3100,2939,161,5.2
5099,AR,Nevada,3616,3482,134,3.7
5101,AR,Newton,3411,3280,131,3.8
5103,AR,Ouachita,9816,9320,496,5.1
5105,AR,Perry,4167,3968,199,4.8
5107,AR,Phillips,6657,6265,392,5.9
5109,AR,Pike,4170,3991,179,4.3
5111,AR,Poinsett,10091,9661,430,4.3
5113,AR,Polk,8150,7752,398,4.9
5115,AR,Pope,29216,27874,1342,4.6
5117,AR,Prairie,3650,3511,139,3.8
5119,AR,Pulaski,187109,180487,6622,3.5
5121,AR,Randolph,6521,6221,300,4.6
5123,AR,St. Francis,8829,8371,458,5.2
5125,AR,Saline,56860,55089,1771,3.1
5127,AR,Scott,4420,4256,164,3.7
5129,AR,Searcy,2989,2853,136,4.6
5131,AR,Sebastian,57601,55461,2140,3.7
5133,AR,Sevier,5627,5352,275,4.9
5135,AR,Sharp,6050,5722,328,5.4
5137,AR,Stone,4740,4497,243,5.1
5139,AR,Union,16312,15421,891,5.5
5141,AR,Van Buren,6101,5682,419,6.9
5143,AR,Washington,118386,115134,3252,2.7
5145,AR,White,34022,32258,1764,5.2
5147,AR,Woodruff,2968,2806,162,5.5
5149,AR,Yell,8668,8281,387,4.5
6001,CA,Alameda,832455,796753,35702,4.3
6003,CA,Alpine,555,519,36,6.5
6005,CA,Amador,14534,13670,864,5.9
6007,CA,Butte,101713,94995,6718,6.6
6009,CA,Calaveras,20812,19632,1180,5.7
6011,CA,Colusa,10910,9214,1696,15.5
6013,CA,Contra Costa,553635,528876,24759,4.5
6015,CA,Del Norte,9762,9028,734,7.5
6017,CA,El Dorado,88888,84324,4564,5.1
6019,CA,Fresno,444982,402728,42254,9.5
6021,CA,Glenn,12956,11878,1078,8.3
6023,CA,Humboldt,62468,59391,3077,4.9
6025,CA,Imperial,75207,57049,18158,24.1
6027,CA,Inyo,8865,8397,468,5.3
6029,CA,Kern,388311,348006,40305,10.4
6031,CA,Kings,57189,51492,5697,10
6033,CA,Lake,29086,27133,1953,6.7
6035,CA,Lassen,10369,9650,719,6.9
6037,CA,Los Angeles,5041430,4776678,264752,5.3
6039,CA,Madera,61085,55443,5642,9.2
6041,CA,Marin,139744,135162,4582,3.3
6043,CA,Mariposa,7573,7054,519,6.9
6045,CA,Mendocino,39644,37555,2089,5.3
6047,CA,Merced,114393,102304,12089,10.6
6049,CA,Modoc,3294,3037,257,7.8
6051,CA,Mono,8372,7923,449,5.4
6053,CA,Monterey,218899,202158,16741,7.6
6055,CA,Napa,72994,69862,3132,4.3
6057,CA,Nevada,48182,45879,2303,4.8
6059,CA,Orange,1598784,1534101,64683,4
6061,CA,Placer,179769,171704,8065,4.5
6063,CA,Plumas,7854,7091,763,9.7
6065,CA,Riverside,1052365,988072,64293,6.1
6067,CA,Sacramento,694482,656950,37532,5.4
6069,CA,San Benito,30453,28423,2030,6.7
6071,CA,San Bernardino,930888,877173,53715,5.8
6073,CA,San Diego,1564339,1490482,73857,4.7
6075,CA,San Francisco/city,555755,537455,18300,3.3
6077,CA,San Joaquin,318508,292630,25878,8.1
6079,CA,San Luis Obispo,139585,133558,6027,4.3
6081,CA,San Mateo,442147,428667,13480,3
6083,CA,Santa Barbara,215420,204513,10907,5.1
6085,CA,Santa Clara,1028720,989938,38782,3.8
6087,CA,Santa Cruz,143850,133851,9999,7
6089,CA,Shasta,74255,69082,5173,7
6091,CA,Sierra,1334,1233,101,7.6
6093,CA,Siskiyou,17906,16385,1521,8.5
6095,CA,Solano,207419,196011,11408,5.5
6097,CA,Sonoma,259412,249100,10312,4
6099,CA,Stanislaus,242879,221970,20909,8.6
6101,CA,Sutter,45006,40649,4357,9.7
6103,CA,Tehama,25088,23302,1786,7.1
6105,CA,Trinity,4996,4642,354,7.1
6107,CA,Tulare,203393,180666,22727,11.2
6109,CA,Tuolumne,21582,20240,1342,6.2
6111,CA,Ventura,425658,403448,22210,5.2
6113,CA,Yolo,106150,99902,6248,5.9
6115,CA,Yuba,28170,25746,2424,8.6
8001,CO,Adams,253825,244897,8928,3.5
8003,CO,Alamosa,7974,7657,317,4
8005,CO,Arapahoe,340924,330523,10401,3.1
8007,CO,Archuleta,6371,6165,206,3.2
8009,CO,Baca,2094,2059,35,1.7
8011,CO,Bent,1853,1797,56,3
8013,CO,Boulder,181034,176281,4753,2.6
8014,CO,Broomfield/city,36815,35767,1048,2.8
8015,CO,Chaffee,8851,8620,231,2.6
8017,CO,Cheyenne,1082,1058,24,2.2
8019,CO,Clear Creek,5693,5513,180,3.2
8021,CO,Conejos,3775,3594,181,4.8
8023,CO,Costilla,1730,1648,82,4.7
8025,CO,Crowley,1423,1374,49,3.4
8027,CO,Custer,2020,1958,62,3.1
8029,CO,Delta,13969,13293,676,4.8
8031,CO,Denver/city,385402,373636,11766,3.1
8033,CO,Dolores,1072,1031,41,3.8
8035,CO,Douglas,177701,173038,4663,2.6
8037,CO,Eagle,33758,32846,912,2.7
8039,CO,Elbert,13812,13459,353,2.6
8041,CO,El Paso,314984,303345,11639,3.7
8043,CO,Fremont,14717,13968,749,5.1
8045,CO,Garfield,31024,29957,1067,3.4
8047,CO,Gilpin,3488,3406,82,2.4
8049,CO,Grand,9197,8954,243,2.6
8051,CO,Gunnison,10146,9917,229,2.3
8053,CO,Hinsdale,448,437,11,2.5
8055,CO,Huerfano,2503,2347,156,6.2
8057,CO,Jackson,892,869,23,2.6
8059,CO,Jefferson,315665,306485,9180,2.9
8061,CO,Kiowa,847,830,17,2
8063,CO,Kit Carson,4543,4448,95,2.1
8065,CO,Lake,4622,4492,130,2.8
8067,CO,La Plata,31017,30141,876,2.8
8069,CO,Larimer,187550,182372,5178,2.8
8071,CO,Las Animas,6192,5884,308,5
8073,CO,Lincoln,2282,2224,58,2.5
8075,CO,Logan,11026,10707,319,2.9
8077,CO,Mesa,72159,68373,3786,5.2
8079,CO,Mineral,464,454,10,2.2
8081,CO,Moffat,7189,6908,281,3.9
8083,CO,Montezuma,12735,12112,623,4.9
8085,CO,Montrose,20086,19268,818,4.1
8087,CO,Morgan,15054,14542,512,3.4
8089,CO,Otero,8121,7745,376,4.6
8091,CO,Ouray,2168,2088,80,3.7
8093,CO,Park,9844,9574,270,2.7
8095,CO,Phillips,2474,2426,48,1.9
8097,CO,Pitkin,10747,10390,357,3.3
8099,CO,Prowers,6010,5819,191,3.2
8101,CO,Pueblo,73155,69712,3443,4.7
8103,CO,Rio Blanco,2740,2603,137,5
8105,CO,Rio Grande,5161,4909,252,4.9
8107,CO,Routt,14923,14538,385,2.6
8109,CO,Saguache,3230,3075,155,4.8
8111,CO,San Juan,480,463,17,3.5
8113,CO,San Miguel,5190,5024,166,3.2
8115,CO,Sedgwick,1179,1152,27,2.3
8117,CO,Summit,21150,20719,431,2
8119,CO,Teller,11743,11315,428,3.6
8121,CO,Washington,2923,2861,62,2.1
8123,CO,Weld,150089,145044,5045,3.4
8125,CO,Yuma,5444,5330,114,2.1
9001,CT,Fairfield,480522,457108,23414,4.9
9003,CT,Hartford,474523,449088,25435,5.4
9005,CT,Litchfield,104779,99828,4951,4.7
9007,CT,Middlesex,92223,88120,4103,4.4
9009,CT,New Haven,455053,429903,25150,5.5
9011,CT,New London,136008,129023,6985,5.1
9013,CT,Tolland,85364,81528,3836,4.5
9015,CT,Windham,62804,59308,3496,5.6
10001,DE,Kent,77259,73467,3792,4.9
10003,DE,New Castle,293884,280885,12999,4.4
10005,DE,Sussex,101100,96560,4540,4.5
11001,District of Columbia,District of Columbia,395424,371295,24129,6.1
12001,FL,Alachua,132521,126849,5672,4.3
12003,FL,Baker,11409,10853,556,4.9
12005,FL,Bay,87847,83662,4185,4.8
12007,FL,Bradford,10852,10390,462,4.3
12009,FL,Brevard,262336,248927,13409,5.1
12011,FL,Broward,1003202,958071,45131,4.5
12013,FL,Calhoun,4982,4696,286,5.7
12015,FL,Charlotte,69230,65546,3684,5.3
12017,FL,Citrus,47800,44588,3212,6.7
12019,FL,Clay,100942,96402,4540,4.5
12021,FL,Collier,169065,161176,7889,4.7
12023,FL,Columbia,29734,28286,1448,4.9
12027,FL,DeSoto,13459,12751,708,5.3
12029,FL,Dixie,5646,5339,307,5.4
12031,FL,Duval,467244,444319,22925,4.9
12033,FL,Escambia,140836,133868,6968,4.9
12035,FL,Flagler,45303,42813,2490,5.5
12037,FL,Franklin,4732,4527,205,4.3
12039,FL,Gadsden,18192,17053,1139,6.3
12041,FL,Gilchrist,6671,6338,333,5
12043,FL,Glades,4714,4420,294,6.2
12045,FL,Gulf,5961,5684,277,4.6
12047,FL,Hamilton,4653,4390,263,5.7
12049,FL,Hardee,9247,8633,614,6.6
12051,FL,Hendry,15391,14082,1309,8.5
12053,FL,Hernando,67864,63763,4101,6
12055,FL,Highlands,35694,33362,2332,6.5
12057,FL,Hillsborough,706663,675394,31269,4.4
12059,FL,Holmes,6706,6344,362,5.4
12061,FL,Indian River,62131,58395,3736,6
12063,FL,Jackson,17324,16421,903,5.2
12065,FL,Jefferson,5382,5099,283,5.3
12067,FL,Lafayette,2965,2836,129,4.4
12069,FL,Lake,145974,138893,7081,4.9
12071,FL,Lee,329055,313867,15188,4.6
12073,FL,Leon,150092,143297,6795,4.5
12075,FL,Levy,16633,15774,859,5.2
12077,FL,Liberty,2635,2500,135,5.1
12079,FL,Madison,7319,6935,384,5.2
12081,FL,Manatee,170456,162699,7757,4.6
12083,FL,Marion,131913,124245,7668,5.8
12085,FL,Martin,70833,67404,3429,4.8
12086,FL,Miami-Dade,1324474,1256325,68149,5.1
12087,FL,Monroe,46410,44934,1476,3.2
12089,FL,Nassau,37743,36047,1696,4.5
12091,FL,Okaloosa,93159,89419,3740,4
12093,FL,Okeechobee,18131,17201,930,5.1
12095,FL,Orange,705953,675257,30696,4.3
12097,FL,Osceola,164117,155983,8134,5
12099,FL,Palm Beach,708677,675422,33255,4.7
12101,FL,Pasco,222330,210938,11392,5.1
12103,FL,Pinellas,477837,457088,20749,4.3
12105,FL,Polk,286641,270817,15824,5.5
12107,FL,Putnam,26954,25241,1713,6.4
12109,FL,St. Johns,118494,114014,4480,3.8
12111,FL,St. Lucie,135087,127280,7807,5.8
12113,FL,Santa Rosa,76061,72633,3428,4.5
12115,FL,Sarasota,180870,172654,8216,4.5
12117,FL,Seminole,241834,231507,10327,4.3
12119,FL,Sumter,29362,27261,2101,7.2
12121,FL,Suwannee,18169,17280,889,4.9
12123,FL,Taylor,8829,8353,476,5.4
12125,FL,Union,4792,4585,207,4.3
12127,FL,Volusia,245272,232868,12404,5.1
12129,FL,Wakulla,14284,13694,590,4.1
12131,FL,Walton,28917,27676,1241,4.3
12133,FL,Washington,9692,9195,497,5.1
13001,GA,Appling,9189,8604,585,6.4
13003,GA,Atkinson,3976,3769,207,5.2
13005,GA,Bacon,4982,4722,260,5.2
13007,GA,Baker,1181,1090,91,7.7
13009,GA,Baldwin,17633,16430,1203,6.8
13011,GA,Banks,8816,8389,427,4.8
13013,GA,Barrow,37699,35927,1772,4.7
13015,GA,Bartow,48191,45731,2460,5.1
13017,GA,Ben Hill,5547,5093,454,8.2
13019,GA,Berrien,7220,6779,441,6.1
13021,GA,Bibb,68646,64580,4066,5.9
13023,GA,Bleckley,4502,4146,356,7.9
13025,GA,Brantley,7095,6620,475,6.7
13027,GA,Brooks,7011,6644,367,5.2
13029,GA,Bryan,16929,16108,821,4.8
13031,GA,Bulloch,35964,33912,2052,5.7
13033,GA,Burke,9241,8531,710,7.7
13035,GA,Butts,10378,9795,583,5.6
13037,GA,Calhoun,2163,2041,122,5.6
13039,GA,Camden,20351,19183,1168,5.7
13043,GA,Candler,5072,4830,242,4.8
13045,GA,Carroll,53541,50337,3204,6
13047,GA,Catoosa,32173,30624,1549,4.8
13049,GA,Charlton,4740,4474,266,5.6
13051,GA,Chatham,136081,128973,7108,5.2
13053,GA,Chattahoochee,2059,1889,170,8.3
13055,GA,Chattooga,10435,9779,656,6.3
13057,GA,Cherokee,125900,120561,5339,4.2
13059,GA,Clarke,58761,55533,3228,5.5
13061,GA,Clay,883,792,91,10.3
13063,GA,Clayton,130760,122159,8601,6.6
13065,GA,Clinch,2769,2599,170,6.1
13067,GA,Cobb,410112,391343,18769,4.6
13069,GA,Coffee,18086,17038,1048,5.8
13071,GA,Colquitt,21099,19995,1104,5.2
13073,GA,Columbia,71048,67761,3287,4.6
13075,GA,Cook,7523,7117,406,5.4
13077,GA,Coweta,70400,66914,3486,5
13079,GA,Crawford,5677,5344,333,5.9
13081,GA,Crisp,9189,8637,552,6
13083,GA,Dade,8017,7614,403,5
13085,GA,Dawson,11331,10803,528,4.7
13087,GA,Decatur,11473,10713,760,6.6
13089,GA,DeKalb,382702,362151,20551,5.4
13091,GA,Dodge,7015,6507,508,7.2
13093,GA,Dooly,4950,4664,286,5.8
13095,GA,Dougherty,38158,35556,2602,6.8
13097,GA,Douglas,70221,66334,3887,5.5
13099,GA,Early,4400,4099,301,6.8
13101,GA,Echols,1883,1802,81,4.3
13103,GA,Effingham,28415,27050,1365,4.8
13105,GA,Elbert,7729,7230,499,6.5
13107,GA,Emanuel,8446,7795,651,7.7
13109,GA,Evans,4788,4554,234,4.9
13111,GA,Fannin,10828,10251,577,5.3
13113,GA,Fayette,55714,53099,2615,4.7
13115,GA,Floyd,43497,40895,2602,6
13117,GA,Forsyth,111003,106392,4611,4.2
13119,GA,Franklin,9787,9277,510,5.2
13121,GA,Fulton,531088,502625,28463,5.4
13123,GA,Gilmer,11834,11165,669,5.7
13125,GA,Glascock,1268,1192,76,6
13127,GA,Glynn,39176,37105,2071,5.3
13129,GA,Gordon,25299,23888,1411,5.6
13131,GA,Grady,10253,9698,555,5.4
13133,GA,Greene,6604,6206,398,6
13135,GA,Gwinnett,467718,445552,22166,4.7
13137,GA,Habersham,19302,18286,1016,5.3
13139,GA,Hall,96314,91998,4316,4.5
13141,GA,Hancock,2530,2319,211,8.3
13143,GA,Haralson,12157,11455,702,5.8
13145,GA,Harris,16068,15287,781,4.9
13147,GA,Hart,11012,10423,589,5.3
13149,GA,Heard,4996,4702,294,5.9
13151,GA,Henry,108905,102937,5968,5.5
13153,GA,Houston,67668,64064,3604,5.3
13155,GA,Irwin,3218,2967,251,7.8
13157,GA,Jackson,33289,31876,1413,4.2
13159,GA,Jasper,6582,6268,314,4.8
13161,GA,Jeff Davis,6226,5832,394,6.3
13163,GA,Jefferson,6596,6111,485,7.4
13165,GA,Jenkins,3162,2924,238,7.5
13167,GA,Johnson,3925,3687,238,6.1
13169,GA,Jones,13793,13133,660,4.8
13171,GA,Lamar,7898,7382,516,6.5
13173,GA,Lanier,3827,3607,220,5.7
13175,GA,Laurens,19062,17799,1263,6.6
13177,GA,Lee,14557,13877,680,4.7
13179,GA,Liberty,25043,23584,1459,5.8
13181,GA,Lincoln,3478,3274,204,5.9
13183,GA,Long,7424,7025,399,5.4
13185,GA,Lowndes,51309,48613,2696,5.3
13187,GA,Lumpkin,15971,15210,761,4.8
13189,GA,McDuffie,8800,8159,641,7.3
13191,GA,McIntosh,6003,5654,349,5.8
13193,GA,Macon,4679,4293,386,8.2
13195,GA,Madison,13083,12439,644,4.9
13197,GA,Marion,3380,3133,247,7.3
13199,GA,Meriwether,8757,8158,599,6.8
13201,GA,Miller,2753,2605,148,5.4
13205,GA,Mitchell,8569,8009,560,6.5
13207,GA,Monroe,13018,12348,670,5.1
13209,GA,Montgomery,3724,3448,276,7.4
13211,GA,Morgan,8698,8261,437,5
13213,GA,Murray,15641,14536,1105,7.1
13215,GA,Muscogee,78420,73115,5305,6.8
13217,GA,Newton,49997,47014,2983,6
13219,GA,Oconee,18476,17722,754,4.1
13221,GA,Oglethorpe,6919,6584,335,4.8
13223,GA,Paulding,79651,75983,3668,4.6
13225,GA,Peach,11438,10640,798,7
13227,GA,Pickens,14402,13705,697,4.8
13229,GA,Pierce,8555,8104,451,5.3
13231,GA,Pike,8403,7969,434,5.2
13233,GA,Polk,18070,16965,1105,6.1
13235,GA,Pulaski,4039,3803,236,5.8
13237,GA,Putnam,7952,7394,558,7
13239,GA,Quitman,815,756,59,7.2
13241,GA,Rabun,6697,6303,394,5.9
13243,GA,Randolph,2473,2265,208,8.4
13245,GA,Richmond,84825,79116,5709,6.7
13247,GA,Rockdale,43247,40751,2496,5.8
13249,GA,Schley,2116,1983,133,6.3
13251,GA,Screven,5238,4845,393,7.5
13253,GA,Seminole,3092,2850,242,7.8
13255,GA,Spalding,27789,25887,1902,6.8
13257,GA,Stephens,11033,10387,646,5.9
13259,GA,Stewart,2137,2001,136,6.4
13261,GA,Sumter,12843,11875,968,7.5
13263,GA,Talbot,2745,2562,183,6.7
13265,GA,Taliaferro,549,511,38,6.9
13267,GA,Tattnall,9332,8834,498,5.3
13269,GA,Taylor,3323,3075,248,7.5
13271,GA,Telfair,4812,4411,401,8.3
13273,GA,Terrell,3656,3420,236,6.5
13275,GA,Thomas,17531,16442,1089,6.2
13277,GA,Tift,18552,17558,994,5.4
13279,GA,Toombs,11785,10868,917,7.8
13281,GA,Towns,4107,3829,278,6.8
13283,GA,Treutlen,2741,2531,210,7.7
13285,GA,Troup,36837,34968,1869,5.1
13287,GA,Turner,3236,3027,209,6.5
13289,GA,Twiggs,2949,2693,256,8.7
13291,GA,Union,10449,9956,493,4.7
13293,GA,Upson,11141,10426,715,6.4
13295,GA,Walker,29936,28274,1662,5.6
13297,GA,Walton,43381,41259,2122,4.9
13299,GA,Ware,15482,14651,831,5.4
13301,GA,Warren,2699,2512,187,6.9
13303,GA,Washington,7183,6730,453,6.3
13305,GA,Wayne,11294,10523,771,6.8
13307,GA,Webster,966,883,83,8.6
13309,GA,Wheeler,1733,1578,155,8.9
13311,GA,White,14482,13813,669,4.6
13313,GA,Whitfield,44740,42014,2726,6.1
13315,GA,Wilcox,2720,2525,195,7.2
13317,GA,Wilkes,3707,3462,245,6.6
13319,GA,Wilkinson,3651,3420,231,6.3
13321,GA,Worth,9123,8593,530,5.8
15001,HI,Hawaii,91367,88009,3358,3.7
15003,HI,Honolulu/city,470086,457073,13013,2.8
15007,HI,Kauai,35802,34648,1154,3.2
15009,HI,Maui,85706,83054,2652,3.1
16001,ID,Ada,225651,218199,7452,3.3
16003,ID,Adams,1749,1627,122,7
16005,ID,Bannock,41168,39697,1471,3.6
16007,ID,Bear Lake,2817,2688,129,4.6
16009,ID,Benewah,4022,3782,240,6
16011,ID,Bingham,22842,22035,807,3.5
16013,ID,Blaine,11873,11497,376,3.2
16015,ID,Boise,3105,2939,166,5.3
16017,ID,Bonner,18933,17902,1031,5.4
16019,ID,Bonneville,52500,50826,1674,3.2
16021,ID,Boundary,5119,4848,271,5.3
16023,ID,Butte,1297,1243,54,4.2
16025,ID,Camas,659,635,24,3.6
16027,ID,Canyon,93825,89735,4090,4.4
16029,ID,Caribou,3803,3666,137,3.6
16031,ID,Cassia,11615,11268,347,3
16033,ID,Clark,394,381,13,3.3
16035,ID,Clearwater,3058,2833,225,7.4
16037,ID,Custer,2147,2036,111,5.2
16039,ID,Elmore,10980,10524,456,4.2
16041,ID,Franklin,6655,6450,205,3.1
16043,ID,Fremont,7385,7136,249,3.4
16045,ID,Gem,7747,7382,365,4.7
16047,ID,Gooding,8016,7769,247,3.1
16049,ID,Idaho,6357,5994,363,5.7
16051,ID,Jefferson,12853,12455,398,3.1
16053,ID,Jerome,11371,11012,359,3.2
16055,ID,Kootenai,74006,70537,3469,4.7
16057,ID,Latah,19939,19305,634,3.2
16059,ID,Lemhi,3417,3206,211,6.2
16061,ID,Lewis,1629,1526,103,6.3
16063,ID,Lincoln,2648,2529,119,4.5
16065,ID,Madison,20607,20108,499,2.4
16067,ID,Minidoka,10898,10549,349,3.2
16069,ID,Nez Perce,20910,20223,687,3.3
16071,ID,Oneida,2206,2126,80,3.6
16073,ID,Owyhee,5292,5049,243,4.6
16075,ID,Payette,11282,10756,526,4.7
16077,ID,Power,3939,3777,162,4.1
16079,ID,Shoshone,5130,4763,367,7.2
16081,ID,Teton,5995,5801,194,3.2
16083,ID,Twin Falls,39652,38298,1354,3.4
16085,ID,Valley,4980,4707,273,5.5
16087,ID,Washington,4610,4355,255,5.5
17001,IL,Adams,32482,30935,1547,4.8
17003,IL,Alexander,2205,1999,206,9.3
17005,IL,Bond,7878,7474,404,5.1
17007,IL,Boone,26373,24696,1677,6.4
17009,IL,Brown,2855,2759,96,3.4
17011,IL,Bureau,17373,16323,1050,6
17013,IL,Calhoun,2374,2227,147,6.2
17015,IL,Carroll,7864,7420,444,5.6
17017,IL,Cass,6238,5892,346,5.5
17019,IL,Champaign,105414,100035,5379,5.1
17021,IL,Christian,15369,14393,976,6.4
17023,IL,Clark,8162,7687,475,5.8
17025,IL,Clay,6705,6247,458,6.8
17027,IL,Clinton,20450,19537,913,4.5
17029,IL,Coles,24522,23074,1448,5.9
17031,IL,Cook,2665321,2504624,160697,6
17033,IL,Crawford,9026,8462,564,6.2
17035,IL,Cumberland,5981,5670,311,5.2
17037,IL,DeKalb,55086,52136,2950,5.4
17039,IL,De Witt,7909,7457,452,5.7
17041,IL,Douglas,10230,9745,485,4.7
17043,IL,DuPage,517069,492745,24324,4.7
17045,IL,Edgar,9704,9123,581,6
17047,IL,Edwards,2972,2799,173,5.8
17049,IL,Effingham,18686,17803,883,4.7
17051,IL,Fayette,9754,9110,644,6.6
17053,IL,Ford,6545,6184,361,5.5
17055,IL,Franklin,16691,15339,1352,8.1
17057,IL,Fulton,15807,14639,1168,7.4
17059,IL,Gallatin,2535,2342,193,7.6
17061,IL,Greene,6068,5715,353,5.8
17063,IL,Grundy,25768,24043,1725,6.7
17065,IL,Hamilton,4257,3990,267,6.3
17067,IL,Hancock,8830,8253,577,6.5
17069,IL,Hardin,1399,1263,136,9.7
17071,IL,Henderson,3717,3490,227,6.1
17073,IL,Henry,25204,23681,1523,6
17075,IL,Iroquois,14842,14027,815,5.5
17077,IL,Jackson,28680,27132,1548,5.4
17079,IL,Jasper,4646,4354,292,6.3
17081,IL,Jefferson,17567,16441,1126,6.4
17083,IL,Jersey,11056,10410,646,5.8
17085,IL,Jo Daviess,11375,10763,612,5.4
17087,IL,Johnson,4209,3842,367,8.7
17089,IL,Kane,269704,254742,14962,5.5
17091,IL,Kankakee,55303,51760,3543,6.4
17093,IL,Kendall,67998,64531,3467,5.1
17095,IL,Knox,22943,21530,1413,6.2
17097,IL,Lake,372538,353051,19487,5.2
17099,IL,LaSalle,57112,53247,3865,6.8
17101,IL,Lawrence,6175,5717,458,7.4
17103,IL,Lee,18020,17095,925,5.1
17105,IL,Livingston,17018,16096,922,5.4
17107,IL,Logan,13076,12380,696,5.3
17109,IL,McDonough,14027,13147,880,6.3
17111,IL,McHenry,167954,159180,8774,5.2
17113,IL,McLean,90137,85557,4580,5.1
17115,IL,Macon,50284,46946,3338,6.6
17117,IL,Macoupin,23358,21965,1393,6
17119,IL,Madison,135105,127143,7962,5.9
17121,IL,Marion,18025,16874,1151,6.4
17123,IL,Marshall,5636,5263,373,6.6
17125,IL,Mason,6441,5981,460,7.1
17127,IL,Massac,5992,5564,428,7.1
17129,IL,Menard,6901,6585,316,4.6
17131,IL,Mercer,8219,7708,511,6.2
17133,IL,Monroe,18485,17734,751,4.1
17135,IL,Montgomery,12140,11280,860,7.1
17137,IL,Morgan,17000,16163,837,4.9
17139,IL,Moultrie,7437,7095,342,4.6
17141,IL,Ogle,25804,24279,1525,5.9
17143,IL,Peoria,88138,82056,6082,6.9
17145,IL,Perry,8705,8086,619,7.1
17147,IL,Piatt,8539,8117,422,4.9
17149,IL,Pike,7507,7124,383,5.1
17151,IL,Pope,1761,1640,121,6.9
17153,IL,Pulaski,2194,2008,186,8.5
17155,IL,Putnam,3107,2933,174,5.6
17157,IL,Randolph,14546,13818,728,5
17159,IL,Richland,7540,7093,447,5.9
17161,IL,Rock Island,72048,67527,4521,6.3
17163,IL,St. Clair,127187,119457,7730,6.1
17165,IL,Saline,10049,9188,861,8.6
17167,IL,Sangamon,106304,101124,5180,4.9
17169,IL,Schuyler,3358,3169,189,5.6
17171,IL,Scott,2534,2391,143,5.6
17173,IL,Shelby,10384,9788,596,5.7
17175,IL,Stark,2762,2559,203,7.3
17177,IL,Stephenson,21413,20157,1256,5.9
17179,IL,Tazewell,65843,61613,4230,6.4
17181,IL,Union,7524,6966,558,7.4
17183,IL,Vermilion,35080,32546,2534,7.2
17185,IL,Wabash,5753,5392,361,6.3
17187,IL,Warren,8696,8237,459,5.3
17189,IL,Washington,9644,9281,363,3.8
17191,IL,Wayne,7301,6678,623,8.5
17193,IL,White,6889,6437,452,6.6
17195,IL,Whiteside,28727,27060,1667,5.8
17197,IL,Will,363016,341403,21613,6
17199,IL,Williamson,32322,30334,1988,6.2
17201,IL,Winnebago,141580,132144,9436,6.7
17203,IL,Woodford,19372,18310,1062,5.5
18001,IN,Adams,17040,16431,609,3.6
18003,IN,Allen,180882,173176,7706,4.3
18005,IN,Bartholomew,44452,42949,1503,3.4
18007,IN,Benton,4566,4373,193,4.2
18009,IN,Blackford,5337,5052,285,5.3
18011,IN,Boone,34859,33685,1174,3.4
18013,IN,Brown,7523,7221,302,4
18015,IN,Carroll,10109,9681,428,4.2
18017,IN,Cass,18051,17214,837,4.6
18019,IN,Clark,60539,58023,2516,4.2
18021,IN,Clay,12386,11809,577,4.7
18023,IN,Clinton,17153,16488,665,3.9
18025,IN,Crawford,4999,4718,281,5.6
18027,IN,Daviess,15975,15411,564,3.5
18029,IN,Dearborn,25600,24396,1204,4.7
18031,IN,Decatur,14556,14039,517,3.6
18033,IN,DeKalb,22236,21366,870,3.9
18035,IN,Delaware,55087,52268,2819,5.1
18037,IN,Dubois,23397,22670,727,3.1
18039,IN,Elkhart,108476,104705,3771,3.5
18041,IN,Fayette,9351,8814,537,5.7
18043,IN,Floyd,40988,39313,1675,4.1
18045,IN,Fountain,7980,7518,462,5.8
18047,IN,Franklin,11479,10982,497,4.3
18049,IN,Fulton,9889,9426,463,4.7
18051,IN,Gibson,19200,18506,694,3.6
18053,IN,Grant,32144,30563,1581,4.9
18055,IN,Greene,13742,12846,896,6.5
18057,IN,Hamilton,174507,168927,5580,3.2
18059,IN,Hancock,38689,37227,1462,3.8
18061,IN,Harrison,19958,19121,837,4.2
18063,IN,Hendricks,85792,82802,2990,3.5
18065,IN,Henry,22117,21098,1019,4.6
18067,IN,Howard,38083,36313,1770,4.6
18069,IN,Huntington,18688,17932,756,4
18071,IN,Jackson,22348,21532,816,3.7
18073,IN,Jasper,16571,15691,880,5.3
18075,IN,Jay,9946,9496,450,4.5
18077,IN,Jefferson,15287,14576,711,4.7
18079,IN,Jennings,13267,12638,629,4.7
18081,IN,Johnson,80261,77350,2911,3.6
18083,IN,Knox,19066,18235,831,4.4
18085,IN,Kosciusko,41502,39951,1551,3.7
18087,IN,LaGrange,19425,18757,668,3.4
18089,IN,Lake,232251,217590,14661,6.3
18091,IN,LaPorte,48653,45798,2855,5.9
18093,IN,Lawrence,20596,19428,1168,5.7
18095,IN,Madison,58972,56005,2967,5
18097,IN,Marion,481513,460005,21508,4.5
18099,IN,Marshall,24328,23418,910,3.7
18101,IN,Martin,5150,4940,210,4.1
18103,IN,Miami,16088,15330,758,4.7
18105,IN,Monroe,67995,64840,3155,4.6
18107,IN,Montgomery,19160,18424,736,3.8
18109,IN,Morgan,36042,34512,1530,4.2
18111,IN,Newton,7038,6645,393,5.6
18113,IN,Noble,23332,22387,945,4.1
18115,IN,Ohio,3225,3067,158,4.9
18117,IN,Orange,8881,8431,450,5.1
18119,IN,Owen,9260,8746,514,5.6
18121,IN,Parke,7268,6890,378,5.2
18123,IN,Perry,9462,9031,431,4.6
18125,IN,Pike,6332,6057,275,4.3
18127,IN,Porter,86283,81870,4413,5.1
18129,IN,Posey,13453,12923,530,3.9
18131,IN,Pulaski,6380,6095,285,4.5
18133,IN,Putnam,16606,15858,748,4.5
18135,IN,Randolph,12670,12101,569,4.5
18137,IN,Ripley,14067,13423,644,4.6
18139,IN,Rush,8979,8641,338,3.8
18141,IN,St. Joseph,134142,128072,6070,4.5
18143,IN,Scott,10477,9970,507,4.8
18145,IN,Shelby,22958,22043,915,4
18147,IN,Spencer,10977,10528,449,4.1
18149,IN,Starke,10861,10274,587,5.4
18151,IN,Steuben,20085,19351,734,3.7
18153,IN,Sullivan,8700,8190,510,5.9
18155,IN,Switzerland,4996,4753,243,4.9
18157,IN,Tippecanoe,94397,90572,3825,4.1
18159,IN,Tipton,8529,8201,328,3.8
18161,IN,Union,3638,3491,147,4
18163,IN,Vanderburgh,93237,89412,3825,4.1
18165,IN,Vermillion,7272,6794,478,6.6
18167,IN,Vigo,49382,46726,2656,5.4
18169,IN,Wabash,15481,14822,659,4.3
18171,IN,Warren,4112,3913,199,4.8
18173,IN,Warrick,32487,31177,1310,4
18175,IN,Washington,13685,13060,625,4.6
18177,IN,Wayne,30951,29472,1479,4.8
18179,IN,Wells,14170,13666,504,3.6
18181,IN,White,13644,13103,541,4
18183,IN,Whitley,17237,16568,669,3.9
19001,IA,Adair,4232,4108,124,2.9
19003,IA,Adams,2215,2158,57,2.6
19005,IA,Allamakee,7668,7290,378,4.9
19007,IA,Appanoose,6157,5868,289,4.7
19009,IA,Audubon,3275,3168,107,3.3
19011,IA,Benton,13596,13109,487,3.6
19013,IA,Black Hawk,69257,66068,3189,4.6
19015,IA,Boone,15112,14693,419,2.8
19017,IA,Bremer,13904,13410,494,3.6
19019,IA,Buchanan,11200,10742,458,4.1
19021,IA,Buena Vista,11510,11108,402,3.5
19023,IA,Butler,8027,7680,347,4.3
19025,IA,Calhoun,4521,4351,170,3.8
19027,IA,Carroll,11277,10990,287,2.5
19029,IA,Cass,7262,7027,235,3.2
19031,IA,Cedar,10856,10498,358,3.3
19033,IA,Cerro Gordo,23113,22288,825,3.6
19035,IA,Cherokee,6319,6091,228,3.6
19037,IA,Chickasaw,6424,6142,282,4.4
19039,IA,Clarke,4830,4668,162,3.4
19041,IA,Clay,8718,8384,334,3.8
19043,IA,Clayton,10300,9865,435,4.2
19045,IA,Clinton,23809,22641,1168,4.9
19047,IA,Crawford,8435,7977,458,5.4
19049,IA,Dallas,45815,44616,1199,2.6
19051,IA,Davis,4289,4108,181,4.2
19053,IA,Decatur,4405,4264,141,3.2
19055,IA,Delaware,10726,10357,369,3.4
19057,IA,Des Moines,20035,19052,983,4.9
19059,IA,Dickinson,10300,9860,440,4.3
19061,IA,Dubuque,54679,52745,1934,3.5
19063,IA,Emmet,5595,5358,237,4.2
19065,IA,Fayette,10710,10238,472,4.4
19067,IA,Floyd,8689,8375,314,3.6
19069,IA,Franklin,5944,5739,205,3.4
19071,IA,Fremont,3987,3857,130,3.3
19073,IA,Greene,5666,5490,176,3.1
19075,IA,Grundy,6634,6406,228,3.4
19077,IA,Guthrie,5623,5422,201,3.6
19079,IA,Hamilton,7141,6873,268,3.8
19081,IA,Hancock,6390,6219,171,2.7
19083,IA,Hardin,8571,8240,331,3.9
19085,IA,Harrison,7449,7199,250,3.4
19087,IA,Henry,9562,9224,338,3.5
19089,IA,Howard,5328,5138,190,3.6
19091,IA,Humboldt,5387,5232,155,2.9
19093,IA,Ida,4024,3922,102,2.5
19095,IA,Iowa,10557,10231,326,3.1
19097,IA,Jackson,11062,10601,461,4.2
19099,IA,Jasper,19246,18565,681,3.5
19101,IA,Jefferson,9184,8849,335,3.6
19103,IA,Johnson,84310,82138,2172,2.6
19105,IA,Jones,10686,10232,454,4.2
19107,IA,Keokuk,5320,5093,227,4.3
19109,IA,Kossuth,8894,8663,231,2.6
19111,IA,Lee,17458,16411,1047,6
19113,IA,Linn,118783,114458,4325,3.6
19115,IA,Louisa,6101,5864,237,3.9
19117,IA,Lucas,4381,4243,138,3.1
19119,IA,Lyon,7087,6944,143,2
19121,IA,Madison,8250,7959,291,3.5
19123,IA,Mahaska,11798,11363,435,3.7
19125,IA,Marion,17446,16923,523,3
19127,IA,Marshall,19133,18202,931,4.9
19129,IA,Mills,7406,7138,268,3.6
19131,IA,Mitchell,5879,5726,153,2.6
19133,IA,Monona,4725,4533,192,4.1
19135,IA,Monroe,3957,3776,181,4.6
19137,IA,Montgomery,5112,4933,179,3.5
19139,IA,Muscatine,22429,21581,848,3.8
19141,IA,O'Brien,8360,8130,230,2.8
19143,IA,Osceola,3643,3547,96,2.6
19145,IA,Page,6466,6143,323,5
19147,IA,Palo Alto,4966,4813,153,3.1
19149,IA,Plymouth,15008,14627,381,2.5
19151,IA,Pocahontas,4317,4195,122,2.8
19153,IA,Polk,257323,248455,8868,3.4
19155,IA,Pottawattamie,48263,46637,1626,3.4
19157,IA,Poweshiek,10422,10067,355,3.4
19159,IA,Ringgold,2606,2516,90,3.5
19161,IA,Sac,5494,5330,164,3
19163,IA,Scott,86680,82794,3886,4.5
19165,IA,Shelby,6823,6624,199,2.9
19167,IA,Sioux,20685,20214,471,2.3
19169,IA,Story,56963,55637,1326,2.3
19171,IA,Tama,9767,9361,406,4.2
19173,IA,Taylor,3230,3135,95,2.9
19175,IA,Union,6514,6268,246,3.8
19177,IA,Van Buren,3859,3719,140,3.6
19179,IA,Wapello,17889,16859,1030,5.8
19181,IA,Warren,27108,26247,861,3.2
19183,IA,Washington,12355,11995,360,2.9
19185,IA,Wayne,2841,2734,107,3.8
19187,IA,Webster,20430,19620,810,4
19189,IA,Winnebago,5198,5019,179,3.4
19191,IA,Winneshiek,12061,11639,422,3.5
19193,IA,Woodbury,55748,53775,1973,3.5
19195,IA,Worth,4269,4124,145,3.4
19197,IA,Wright,6690,6417,273,4.1
20001,KS,Allen,6439,6080,359,5.6
20003,KS,Anderson,4174,3996,178,4.3
20005,KS,Atchison,7046,6608,438,6.2
20007,KS,Barber,2527,2434,93,3.7
20009,KS,Barton,14024,13396,628,4.5
20011,KS,Bourbon,7127,6782,345,4.8
20013,KS,Brown,5165,4978,187,3.6
20015,KS,Butler,32197,30854,1343,4.2
20017,KS,Chase,1407,1358,49,3.5
20019,KS,Chautauqua,1541,1461,80,5.2
20021,KS,Cherokee,10290,9834,456,4.4
20023,KS,Cheyenne,1345,1307,38,2.8
20025,KS,Clark,1116,1085,31,2.8
20027,KS,Clay,4035,3871,164,4.1
20029,KS,Cloud,4256,4081,175,4.1
20031,KS,Coffey,4283,4018,265,6.2
20033,KS,Comanche,971,941,30,3.1
20035,KS,Cowley,16909,16162,747,4.4
20037,KS,Crawford,18918,18006,912,4.8
20039,KS,Decatur,1293,1242,51,3.9
20041,KS,Dickinson,9167,8762,405,4.4
20043,KS,Doniphan,4274,4109,165,3.9
20045,KS,Douglas,65276,62968,2308,3.5
20047,KS,Edwards,1654,1604,50,3
20049,KS,Elk,1189,1130,59,5
20051,KS,Ellis,17014,16489,525,3.1
20053,KS,Ellsworth,2834,2725,109,3.8
20055,KS,Finney,20152,19531,621,3.1
20057,KS,Ford,17885,17320,565,3.2
20059,KS,Franklin,14227,13631,596,4.2
20061,KS,Geary,12058,11379,679,5.6
20063,KS,Gove,1451,1416,35,2.4
20065,KS,Graham,1225,1171,54,4.4
20067,KS,Grant,3773,3639,134,3.6
20069,KS,Gray,3410,3333,77,2.3
20071,KS,Greeley,912,893,19,2.1
20073,KS,Greenwood,3323,3161,162,4.9
20075,KS,Hamilton,1643,1599,44,2.7
20077,KS,Harper,2881,2778,103,3.6
20079,KS,Harvey,17206,16479,727,4.2
20081,KS,Haskell,2305,2245,60,2.6
20083,KS,Hodgeman,1030,1003,27,2.6
20085,KS,Jackson,7259,7009,250,3.4
20087,KS,Jefferson,10217,9820,397,3.9
20089,KS,Jewell,1331,1274,57,4.3
20091,KS,Johnson,328359,317670,10689,3.3
20093,KS,Kearny,2058,1993,65,3.2
20095,KS,Kingman,3528,3373,155,4.4
20097,KS,Kiowa,1420,1381,39,2.7
20099,KS,Labette,10734,10156,578,5.4
20101,KS,Lane,810,785,25,3.1
20103,KS,Leavenworth,35787,34247,1540,4.3
20105,KS,Lincoln,1737,1678,59,3.4
20107,KS,Linn,4343,4064,279,6.4
20109,KS,Logan,1723,1679,44,2.6
20111,KS,Lyon,16819,16132,687,4.1
20113,KS,McPherson,16340,15825,515,3.2
20115,KS,Marion,6121,5880,241,3.9
20117,KS,Marshall,5563,5395,168,3
20119,KS,Meade,2377,2313,64,2.7
20121,KS,Miami,17022,16315,707,4.2
20123,KS,Mitchell,3696,3574,122,3.3
20125,KS,Montgomery,15999,15020,979,6.1
20127,KS,Morris,3051,2934,117,3.8
20129,KS,Morton,1344,1292,52,3.9
20131,KS,Nemaha,5897,5739,158,2.7
20133,KS,Neosho,6057,5623,434,7.2
20135,KS,Ness,1423,1374,49,3.4
20137,KS,Norton,2872,2802,70,2.4
20139,KS,Osage,8058,7703,355,4.4
20141,KS,Osborne,2059,1989,70,3.4
20143,KS,Ottawa,3163,3043,120,3.8
20145,KS,Pawnee,3210,3104,106,3.3
20147,KS,Phillips,2857,2767,90,3.2
20149,KS,Pottawatomie,12152,11728,424,3.5
20151,KS,Pratt,5104,4897,207,4.1
20153,KS,Rawlins,1545,1508,37,2.4
20155,KS,Reno,30136,28813,1323,4.4
20157,KS,Republic,2544,2474,70,2.8
20159,KS,Rice,5305,5094,211,4
20161,KS,Riley,34889,33707,1182,3.4
20163,KS,Rooks,2668,2543,125,4.7
20165,KS,Rush,1732,1663,69,4
20167,KS,Russell,3574,3424,150,4.2
20169,KS,Saline,30113,28991,1122,3.7
20171,KS,Scott,2887,2816,71,2.5
20173,KS,Sedgwick,247301,235810,11491,4.6
20175,KS,Seward,10232,9787,445,4.3
20177,KS,Shawnee,91684,88015,3669,4
20179,KS,Sheridan,1449,1414,35,2.4
20181,KS,Sherman,2942,2845,97,3.3
20183,KS,Smith,2034,1969,65,3.2
20185,KS,Stafford,2095,2018,77,3.7
20187,KS,Stanton,1071,1041,30,2.8
20189,KS,Stevens,2908,2793,115,4
20191,KS,Sumner,10933,10470,463,4.2
20193,KS,Thomas,4352,4233,119,2.7
20195,KS,Trego,1476,1417,59,4
20197,KS,Wabaunsee,3706,3574,132,3.6
20199,KS,Wallace,860,837,23,2.7
20201,KS,Washington,3084,2983,101,3.3
20203,KS,Wichita,1206,1178,28,2.3
20205,KS,Wilson,4116,3869,247,6
20207,KS,Woodson,1617,1524,93,5.8
20209,KS,Wyandotte,76434,72196,4238,5.5
21001,KY,Adair,7081,6610,471,6.7
21003,KY,Allen,8845,8461,384,4.3
21005,KY,Anderson,11449,10985,464,4.1
21007,KY,Ballard,3641,3314,327,9
21009,KY,Barren,18845,17952,893,4.7
21011,KY,Bath,4756,4403,353,7.4
21013,KY,Bell,8655,7855,800,9.2
21015,KY,Boone,67213,64634,2579,3.8
21017,KY,Bourbon,9872,9399,473,4.8
21019,KY,Boyd,18539,17026,1513,8.2
21021,KY,Boyle,12304,11690,614,5
21023,KY,Bracken,3829,3597,232,6.1
21025,KY,Breathitt,3745,3374,371,9.9
21027,KY,Breckinridge,7730,7242,488,6.3
21029,KY,Bullitt,40495,38800,1695,4.2
21031,KY,Butler,5158,4875,283,5.5
21033,KY,Caldwell,5351,5058,293,5.5
21035,KY,Calloway,18678,17827,851,4.6
21037,KY,Campbell,48680,46805,1875,3.9
21039,KY,Carlisle,2562,2396,166,6.5
21041,KY,Carroll,5179,4921,258,5
21043,KY,Carter,9939,8883,1056,10.6
21045,KY,Casey,6684,6359,325,4.9
21047,KY,Christian,24878,23338,1540,6.2
21049,KY,Clark,17009,16185,824,4.8
21051,KY,Clay,5451,4895,556,10.2
21053,KY,Clinton,3748,3464,284,7.6
21055,KY,Crittenden,4019,3807,212,5.3
21057,KY,Cumberland,2888,2722,166,5.7
21059,KY,Daviess,46651,44552,2099,4.5
21061,KY,Edmonson,4802,4502,300,6.2
21063,KY,Elliott,2098,1855,243,11.6
21065,KY,Estill,5238,4927,311,5.9
21067,KY,Fayette,171309,165151,6158,3.6
21069,KY,Fleming,5941,5569,372,6.3
21071,KY,Floyd,11453,10150,1303,11.4
21073,KY,Franklin,24424,23422,1002,4.1
21075,KY,Fulton,2066,1922,144,7
21077,KY,Gallatin,3900,3710,190,4.9
21079,KY,Garrard,7520,7152,368,4.9
21081,KY,Grant,11341,10785,556,4.9
21083,KY,Graves,15299,14340,959,6.3
21085,KY,Grayson,10722,9997,725,6.8
21087,KY,Green,4996,4770,226,4.5
21089,KY,Greenup,13884,12674,1210,8.7
21091,KY,Hancock,4037,3819,218,5.4
21093,KY,Hardin,47758,45602,2156,4.5
21095,KY,Harlan,6744,5851,893,13.2
21097,KY,Harrison,8487,8084,403,4.7
21099,KY,Hart,7896,7520,376,4.8
21101,KY,Henderson,21589,20556,1033,4.8
21103,KY,Henry,7920,7592,328,4.1
21105,KY,Hickman,1920,1804,116,6
21107,KY,Hopkins,19624,18495,1129,5.8
21109,KY,Jackson,4166,3834,332,8
21111,KY,Jefferson,386432,369244,17188,4.4
21113,KY,Jessamine,25643,24630,1013,4
21115,KY,Johnson,7012,6285,727,10.4
21117,KY,Kenton,84655,81154,3501,4.1
21119,KY,Knott,4559,4028,531,11.6
21121,KY,Knox,9894,9098,796,8
21123,KY,Larue,5895,5621,274,4.6
21125,KY,Laurel,23901,22408,1493,6.2
21127,KY,Lawrence,5042,4488,554,11
21129,KY,Lee,1898,1711,187,9.9
21131,KY,Leslie,2791,2412,379,13.6
21133,KY,Letcher,6425,5623,802,12.5
21135,KY,Lewis,4743,4273,470,9.9
21137,KY,Lincoln,9143,8583,560,6.1
21139,KY,Livingston,3685,3418,267,7.2
21141,KY,Logan,11722,11204,518,4.4
21143,KY,Lyon,2960,2784,176,5.9
21145,KY,McCracken,28986,27303,1683,5.8
21147,KY,McCreary,4601,4227,374,8.1
21149,KY,McLean,4329,4119,210,4.9
21151,KY,Madison,45073,43173,1900,4.2
21153,KY,Magoffin,3147,2520,627,19.9
21155,KY,Marion,9393,8993,400,4.3
21157,KY,Marshall,14903,14032,871,5.8
21159,KY,Martin,3084,2764,320,10.4
21161,KY,Mason,7134,6675,459,6.4
21163,KY,Meade,12082,11455,627,5.2
21165,KY,Menifee,2393,2184,209,8.7
21167,KY,Mercer,9881,9400,481,4.9
21169,KY,Metcalfe,4117,3927,190,4.6
21171,KY,Monroe,4599,4403,196,4.3
21173,KY,Montgomery,11848,11080,768,6.5
21175,KY,Morgan,4484,4122,362,8.1
21177,KY,Muhlenberg,11357,10520,837,7.4
21179,KY,Nelson,21688,20693,995,4.6
21181,KY,Nicholas,3217,3031,186,5.8
21183,KY,Ohio,9519,8877,642,6.7
21185,KY,Oldham,31895,30804,1091,3.4
21187,KY,Owen,5484,5247,237,4.3
21189,KY,Owsley,1120,1010,110,9.8
21191,KY,Pendleton,6845,6514,331,4.8
21193,KY,Perry,8553,7620,933,10.9
21195,KY,Pike,20235,18019,2216,11
21197,KY,Powell,4956,4598,358,7.2
21199,KY,Pulaski,25368,23976,1392,5.5
21201,KY,Robertson,804,754,50,6.2
21203,KY,Rockcastle,6679,6268,411,6.2
21205,KY,Rowan,10567,9936,631,6
21207,KY,Russell,6136,5616,520,8.5
21209,KY,Scott,27963,26893,1070,3.8
21211,KY,Shelby,23784,22929,855,3.6
21213,KY,Simpson,8384,8006,378,4.5
21215,KY,Spencer,9646,9276,370,3.8
21217,KY,Taylor,12213,11601,612,5
21219,KY,Todd,5299,5061,238,4.5
21221,KY,Trigg,5816,5487,329,5.7
21223,KY,Trimble,3866,3656,210,5.4
21225,KY,Union,6160,5738,422,6.9
21227,KY,Warren,61929,59489,2440,3.9
21229,KY,Washington,6076,5814,262,4.3
21231,KY,Wayne,7258,6696,562,7.7
21233,KY,Webster,5829,5476,353,6.1
21235,KY,Whitley,13344,12457,887,6.6
21237,KY,Wolfe,1918,1722,196,10.2
21239,KY,Woodford,14745,14268,477,3.2
22001,LA,Acadia Parish,24508,22701,1807,7.4
22003,LA,Allen Parish,8898,8328,570,6.4
22005,LA,Ascension Parish,61985,58960,3025,4.9
22007,LA,Assumption Parish,9206,8435,771,8.4
22009,LA,Avoyelles Parish,15683,14577,1106,7.1
22011,LA,Beauregard Parish,15063,14154,909,6
22013,LA,Bienville Parish,5664,5234,430,7.6
22015,LA,Bossier Parish,57582,54526,3056,5.3
22017,LA,Caddo Parish,107033,99969,7064,6.6
22019,LA,Calcasieu Parish,102880,97972,4908,4.8
22021,LA,Caldwell Parish,3983,3679,304,7.6
22023,LA,Cameron Parish,3818,3651,167,4.4
22025,LA,Catahoula Parish,3423,3105,318,9.3
22027,LA,Claiborne Parish,5950,5554,396,6.7
22029,LA,Concordia Parish,7250,6652,598,8.2
22031,LA,De Soto Parish,10889,10090,799,7.3
22033,LA,East Baton Rouge Parish,232123,220186,11937,5.1
22035,LA,East Carroll Parish,2139,1892,247,11.5
22037,LA,East Feliciana Parish,8103,7637,466,5.8
22039,LA,Evangeline Parish,12671,11734,937,7.4
22041,LA,Franklin Parish,7278,6620,658,9
22043,LA,Grant Parish,8325,7744,581,7
22045,LA,Iberia Parish,30109,27287,2822,9.4
22047,LA,Iberville Parish,14108,13144,964,6.8
22049,LA,Jackson Parish,7083,6689,394,5.6
22051,LA,Jefferson Parish,216487,205085,11402,5.3
22053,LA,Jefferson Davis Parish,13575,12760,815,6
22055,LA,Lafayette Parish,114348,107348,7000,6.1
22057,LA,Lafourche Parish,43292,40577,2715,6.3
22059,LA,LaSalle Parish,6270,5856,414,6.6
22061,LA,Lincoln Parish,21464,20133,1331,6.2
22063,LA,Livingston Parish,68676,65206,3470,5.1
22065,LA,Madison Parish,3834,3491,343,8.9
22067,LA,Morehouse Parish,10620,9593,1027,9.7
22069,LA,Natchitoches Parish,16711,15590,1121,6.7
22071,LA,Orleans Parish,179964,169433,10531,5.9
22073,LA,Ouachita Parish,71554,67212,4342,6.1
22075,LA,Plaquemines Parish,10184,9641,543,5.3
22077,LA,Pointe Coupee Parish,9959,9315,644,6.5
22079,LA,Rapides Parish,57274,53751,3523,6.2
22081,LA,Red River Parish,3809,3580,229,6
22083,LA,Richland Parish,8445,7819,626,7.4
22085,LA,Sabine Parish,9138,8507,631,6.9
22087,LA,St. Bernard Parish,19546,18360,1186,6.1
22089,LA,St. Charles Parish,25323,23980,1343,5.3
22091,LA,St. Helena Parish,4390,4055,335,7.6
22093,LA,St. James Parish,9606,8889,717,7.5
22095,LA,St. John the Baptist Parish,20055,18687,1368,6.8
22097,LA,St. Landry Parish,32807,30164,2643,8.1
22099,LA,St. Martin Parish,22962,21186,1776,7.7
22101,LA,St. Mary Parish,21937,19883,2054,9.4
22103,LA,St. Tammany Parish,117490,111662,5828,5
22105,LA,Tangipahoa Parish,54160,50516,3644,6.7
22107,LA,Tensas Parish,1626,1467,159,9.8
22109,LA,Terrebonne Parish,48950,45547,3403,7
22111,LA,Union Parish,9242,8638,604,6.5
22113,LA,Vermilion Parish,24701,22825,1876,7.6
22115,LA,Vernon Parish,16928,15705,1223,7.2
22117,LA,Washington Parish,16944,15757,1187,7
22119,LA,Webster Parish,15198,13905,1293,8.5
22121,LA,West Baton Rouge Parish,13241,12537,704,5.3
22123,LA,West Carroll Parish,4103,3614,489,11.9
22125,LA,West Feliciana Parish,5328,5053,275,5.2
22127,LA,Winn Parish,5184,4783,401,7.7
23001,ME,Androscoggin,55265,53284,1981,3.6
23003,ME,Aroostook,31428,29723,1705,5.4
23005,ME,Cumberland,161752,157049,4703,2.9
23007,ME,Franklin,14427,13783,644,4.5
23009,ME,Hancock,29139,27826,1313,4.5
23011,ME,Kennebec,62216,59952,2264,3.6
23013,ME,Knox,20683,19956,727,3.5
23015,ME,Lincoln,16992,16364,628,3.7
23017,ME,Oxford,26532,25306,1226,4.6
23019,ME,Penobscot,76882,73553,3329,4.3
23021,ME,Piscataquis,7466,7095,371,5
23023,ME,Sagadahoc,19165,18598,567,3
23025,ME,Somerset,23453,22136,1317,5.6
23027,ME,Waldo,20836,19962,874,4.2
23029,ME,Washington,13989,13214,775,5.5
23031,ME,York,111002,107258,3744,3.4
24001,MD,Allegany,32431,30399,2032,6.3
24003,MD,Anne Arundel,303551,291922,11629,3.8
24005,MD,Baltimore,445314,424500,20814,4.7
24009,MD,Calvert,48799,46903,1896,3.9
24011,MD,Caroline,17669,16821,848,4.8
24013,MD,Carroll,93109,89703,3406,3.7
24015,MD,Cecil,52648,49884,2764,5.2
24017,MD,Charles,83915,80334,3581,4.3
24019,MD,Dorchester,15896,14903,993,6.2
24021,MD,Frederick,128673,123623,5050,3.9
24023,MD,Garrett,15511,14627,884,5.7
24025,MD,Harford,136366,130580,5786,4.2
24027,MD,Howard,179270,173325,5945,3.3
24029,MD,Kent,10246,9745,501,4.9
24031,MD,Montgomery,545139,526217,18922,3.5
24033,MD,Prince George's,500516,478131,22385,4.5
24035,MD,Queen Anne's,26594,25549,1045,3.9
24037,MD,St. Mary's,54797,52456,2341,4.3
24039,MD,Somerset,9242,8568,674,7.3
24041,MD,Talbot,19541,18717,824,4.2
24043,MD,Washington,75424,71535,3889,5.2
24045,MD,Wicomico,50465,47306,3159,6.3
24047,MD,Worcester,25244,22888,2356,9.3
24510,MD,Baltimore city,289714,270515,19199,6.6
25001,MA,Barnstable,111689,106206,5483,4.9
25003,MA,Berkshire,64454,61553,2901,4.5
25005,MA,Bristol,290092,275783,14309,4.9
25007,MA,Dukes,9357,8873,484,5.2
25009,MA,Essex,410886,394525,16361,4
25011,MA,Franklin,39568,38181,1387,3.5
25013,MA,Hampden,222185,210509,11676,5.3
25015,MA,Hampshire,88113,84914,3199,3.6
25017,MA,Middlesex,874454,846752,27702,3.2
25019,MA,Nantucket/town,7053,6740,313,4.4
25021,MA,Norfolk,372849,360254,12595,3.4
25023,MA,Plymouth,271026,259990,11036,4.1
25025,MA,Suffolk,427583,412442,15141,3.5
25027,MA,Worcester,430379,412716,17663,4.1
26001,MI,Alcona,3829,3537,292,7.6
26003,MI,Alger,3264,2996,268,8.2
26005,MI,Allegan,61308,58928,2380,3.9
26007,MI,Alpena,13653,12845,808,5.9
26009,MI,Antrim,10071,9362,709,7
26011,MI,Arenac,6122,5617,505,8.2
26013,MI,Baraga,3221,2957,264,8.2
26015,MI,Barry,30760,29532,1228,4
26017,MI,Bay,51898,49081,2817,5.4
26019,MI,Benzie,8840,8261,579,6.5
26021,MI,Berrien,73829,70173,3656,5
26023,MI,Branch,19110,18192,918,4.8
26025,MI,Calhoun,64433,61344,3089,4.8
26027,MI,Cass,24350,23213,1137,4.7
26029,MI,Charlevoix,13057,12340,717,5.5
26031,MI,Cheboygan,10817,9803,1014,9.4
26033,MI,Chippewa,16393,15139,1254,7.6
26035,MI,Clare,11958,11086,872,7.3
26037,MI,Clinton,40517,39025,1492,3.7
26039,MI,Crawford,5368,4963,405,7.5
26041,MI,Delta,17124,16005,1119,6.5
26043,MI,Dickinson,12508,11861,647,5.2
26045,MI,Eaton,56913,54574,2339,4.1
26047,MI,Emmet,17600,16459,1141,6.5
26049,MI,Genesee,182592,172324,10268,5.6
26051,MI,Gladwin,9889,9200,689,7
26053,MI,Gogebic,6337,5950,387,6.1
26055,MI,Grand Traverse,49398,47286,2112,4.3
26057,MI,Gratiot,18175,17236,939,5.2
26059,MI,Hillsdale,21183,20114,1069,5
26061,MI,Houghton,16570,15558,1012,6.1
26063,MI,Huron,16002,15177,825,5.2
26065,MI,Ingham,148976,142603,6373,4.3
26067,MI,Ionia,29666,28418,1248,4.2
26069,MI,Iosco,10112,9378,734,7.3
26071,MI,Iron,5217,4882,335,6.4
26073,MI,Isabella,35364,33709,1655,4.7
26075,MI,Jackson,74432,70838,3594,4.8
26077,MI,Kalamazoo,132066,126724,5342,4
26079,MI,Kalkaska,7722,7169,553,7.2
26081,MI,Kent,350491,338188,12303,3.5
26083,MI,Keweenaw,942,861,81,8.6
26085,MI,Lake,3754,3473,281,7.5
26087,MI,Lapeer,40747,38113,2634,6.5
26089,MI,Leelanau,10577,10065,512,4.8
26091,MI,Lenawee,47366,45198,2168,4.6
26093,MI,Livingston,100082,95969,4113,4.1
26095,MI,Luce,2403,2241,162,6.7
26097,MI,Mackinac,5191,4680,511,9.8
26099,MI,Macomb,436145,413316,22829,5.2
26101,MI,Manistee,10536,9848,688,6.5
26103,MI,Marquette,33331,31434,1897,5.7
26105,MI,Mason,14280,13451,829,5.8
26107,MI,Mecosta,19110,18039,1071,5.6
26109,MI,Menominee,11253,10674,579,5.1
26111,MI,Midland,41039,39110,1929,4.7
26113,MI,Missaukee,7027,6610,417,5.9
26115,MI,Monroe,76438,73147,3291,4.3
26117,MI,Montcalm,27926,26454,1472,5.3
26119,MI,Montmorency,3060,2750,310,10.1
26121,MI,Muskegon,77463,73253,4210,5.4
26123,MI,Newaygo,23332,22199,1133,4.9
26125,MI,Oakland,653406,626153,27253,4.2
26127,MI,Oceana,12326,11425,901,7.3
26129,MI,Ogemaw,8238,7598,640,7.8
26131,MI,Ontonagon,2203,2015,188,8.5
26133,MI,Osceola,10436,9842,594,5.7
26135,MI,Oscoda,2907,2695,212,7.3
26137,MI,Otsego,11690,10997,693,5.9
26139,MI,Ottawa,155450,150226,5224,3.4
26141,MI,Presque Isle,5288,4784,504,9.5
26143,MI,Roscommon,7871,7206,665,8.4
26145,MI,Saginaw,88627,83913,4714,5.3
26147,MI,St. Clair,74741,70164,4577,6.1
26149,MI,St. Joseph,29134,27935,1199,4.1
26151,MI,Sanilac,19418,18214,1204,6.2
26153,MI,Schoolcraft,3389,3081,308,9.1
26155,MI,Shiawassee,33499,31740,1759,5.3
26157,MI,Tuscola,24228,22712,1516,6.3
26159,MI,Van Buren,35477,33443,2034,5.7
26161,MI,Washtenaw,191582,184589,6993,3.7
26163,MI,Wayne,780340,731188,49152,6.3
26165,MI,Wexford,14703,13843,860,5.8
27001,MN,Aitkin,7047,6553,494,7
27003,MN,Anoka,192442,185277,7165,3.7
27005,MN,Becker,18610,17760,850,4.6
27007,MN,Beltrami,23742,22504,1238,5.2
27009,MN,Benton,21838,20875,963,4.4
27011,MN,Big Stone,2711,2581,130,4.8
27013,MN,Blue Earth,39730,38456,1274,3.2
27015,MN,Brown,14561,13951,610,4.2
27017,MN,Carlton,17790,16849,941,5.3
27019,MN,Carver,56485,54623,1862,3.3
27021,MN,Cass,14195,13229,966,6.8
27023,MN,Chippewa,6985,6671,314,4.5
27025,MN,Chisago,29227,27965,1262,4.3
27027,MN,Clay,35713,34487,1226,3.4
27029,MN,Clearwater,4728,4275,453,9.6
27031,MN,Cook,3102,2962,140,4.5
27033,MN,Cottonwood,5548,5151,397,7.2
27035,MN,Crow Wing,31924,30302,1622,5.1
27037,MN,Dakota,235749,227759,7990,3.4
27039,MN,Dodge,11589,11159,430,3.7
27041,MN,Douglas,20287,19581,706,3.5
27043,MN,Faribault,7341,7019,322,4.4
27045,MN,Fillmore,11530,11066,464,4
27047,MN,Freeborn,16331,15708,623,3.8
27049,MN,Goodhue,26922,25922,1000,3.7
27051,MN,Grant,3296,3142,154,4.7
27053,MN,Hennepin,687472,664578,22894,3.3
27055,MN,Houston,10629,10214,415,3.9
27057,MN,Hubbard,9821,9185,636,6.5
27059,MN,Isanti,20731,19765,966,4.7
27061,MN,Itasca,22086,20201,1885,8.5
27063,MN,Jackson,6115,5839,276,4.5
27065,MN,Kanabec,9016,8431,585,6.5
27067,MN,Kandiyohi,24256,23336,920,3.8
27069,MN,Kittson,2411,2301,110,4.6
27071,MN,Koochiching,6180,5656,524,8.5
27073,MN,Lac qui Parle,3629,3474,155,4.3
27075,MN,Lake,5432,5087,345,6.4
27077,MN,Lake of the Woods,2389,2274,115,4.8
27079,MN,Le Sueur,15602,14841,761,4.9
27081,MN,Lincoln,3393,3269,124,3.7
27083,MN,Lyon,15229,14688,541,3.6
27085,MN,McLeod,19831,18957,874,4.4
27087,MN,Mahnomen,2395,2257,138,5.8
27089,MN,Marshall,5632,5221,411,7.3
27091,MN,Martin,10491,10060,431,4.1
27093,MN,Meeker,13298,12702,596,4.5
27095,MN,Mille Lacs,12758,11999,759,5.9
27097,MN,Morrison,17914,16911,1003,5.6
27099,MN,Mower,20576,19926,650,3.2
27101,MN,Murray,4970,4735,235,4.7
27103,MN,Nicollet,20413,19835,578,2.8
27105,MN,Nobles,11488,11055,433,3.8
27107,MN,Norman,3452,3287,165,4.8
27109,MN,Olmsted,85455,82912,2543,3
27111,MN,Otter Tail,31381,30017,1364,4.3
27113,MN,Pennington,9068,8547,521,5.7
27115,MN,Pine,14878,14011,867,5.8
27117,MN,Pipestone,4915,4728,187,3.8
27119,MN,Polk,17194,16448,746,4.3
27121,MN,Pope,6320,6096,224,3.5
27123,MN,Ramsey,283182,272995,10187,3.6
27125,MN,Red Lake,2296,2128,168,7.3
27127,MN,Redwood,8343,8001,342,4.1
27129,MN,Renville,8439,7996,443,5.2
27131,MN,Rice,36206,34938,1268,3.5
27133,MN,Rock,5927,5790,137,2.3
27135,MN,Roseau,8272,7849,423,5.1
27137,MN,St. Louis,102893,97020,5873,5.7
27139,MN,Scott,80937,78337,2600,3.2
27141,MN,Sherburne,50837,48770,2067,4.1
27143,MN,Sibley,8517,8153,364,4.3
27145,MN,Stearns,89193,85836,3357,3.8
27147,MN,Steele,21250,20493,757,3.6
27149,MN,Stevens,5667,5497,170,3
27151,MN,Swift,5060,4789,271,5.4
27153,MN,Todd,12943,12334,609,4.7
27155,MN,Traverse,1712,1645,67,3.9
27157,MN,Wabasha,12048,11604,444,3.7
27159,MN,Wadena,6266,5895,371,5.9
27161,MN,Waseca,9494,9087,407,4.3
27163,MN,Washington,139211,134566,4645,3.3
27165,MN,Watonwan,6596,6275,321,4.9
27167,MN,Wilkin,3730,3609,121,3.2
27169,MN,Winona,29347,28309,1038,3.5
27171,MN,Wright,73309,70485,2824,3.9
27173,MN,Yellow Medicine,5493,5283,210,3.8
28001,MS,Adams,11266,10338,928,8.2
28003,MS,Alcorn,15843,15022,821,5.2
28005,MS,Amite,4514,4184,330,7.3
28007,MS,Attala,7024,6555,469,6.7
28009,MS,Benton,3053,2848,205,6.7
28011,MS,Bolivar,13420,12452,968,7.2
28013,MS,Calhoun,6194,5863,331,5.3
28015,MS,Carroll,3569,3310,259,7.3
28017,MS,Chickasaw,7103,6637,466,6.6
28019,MS,Choctaw,3732,3522,210,5.6
28021,MS,Claiborne,3096,2745,351,11.3
28023,MS,Clarke,6085,5674,411,6.8
28025,MS,Clay,8030,7380,650,8.1
28027,MS,Coahoma,9230,8430,800,8.7
28029,MS,Copiah,11295,10560,735,6.5
28031,MS,Covington,8167,7724,443,5.4
28033,MS,DeSoto,87410,83736,3674,4.2
28035,MS,Forrest,33432,31522,1910,5.7
28037,MS,Franklin,2857,2653,204,7.1
28039,MS,George,8825,8174,651,7.4
28041,MS,Greene,4292,3980,312,7.3
28043,MS,Grenada,9622,9131,491,5.1
28045,MS,Hancock,18899,17752,1147,6.1
28047,MS,Harrison,86859,82078,4781,5.5
28049,MS,Hinds,110150,104176,5974,5.4
28051,MS,Holmes,5985,5329,656,11
28053,MS,Humphreys,2377,2107,270,11.4
28055,MS,Issaquena,401,345,56,14
28057,MS,Itawamba,10417,9891,526,5
28059,MS,Jackson,59189,55308,3881,6.6
28061,MS,Jasper,6201,5727,474,7.6
28063,MS,Jefferson,2229,1898,331,14.8
28065,MS,Jefferson Davis,4187,3843,344,8.2
28067,MS,Jones,25830,24255,1575,6.1
28069,MS,Kemper,3558,3249,309,8.7
28071,MS,Lafayette,26028,24763,1265,4.9
28073,MS,Lamar,29650,28308,1342,4.5
28075,MS,Lauderdale,31827,29963,1864,5.9
28077,MS,Lawrence,4682,4350,332,7.1
28079,MS,Leake,7765,7296,469,6
28081,MS,Lee,40869,38887,1982,4.8
28083,MS,Leflore,10350,9413,937,9.1
28085,MS,Lincoln,14444,13625,819,5.7
28087,MS,Lowndes,25555,23992,1563,6.1
28089,MS,Madison,53442,51148,2294,4.3
28091,MS,Marion,10279,9608,671,6.5
28093,MS,Marshall,14577,13701,876,6
28095,MS,Monroe,15659,14676,983,6.3
28097,MS,Montgomery,4243,3973,270,6.4
28099,MS,Neshoba,10716,10102,614,5.7
28101,MS,Newton,8653,8145,508,5.9
28103,MS,Noxubee,3970,3643,327,8.2
28105,MS,Oktibbeha,23087,21838,1249,5.4
28107,MS,Panola,13202,12234,968,7.3
28109,MS,Pearl River,23252,21868,1384,6
28111,MS,Perry,4363,4053,310,7.1
28113,MS,Pike,14692,13698,994,6.8
28115,MS,Pontotoc,14456,13775,681,4.7
28117,MS,Prentiss,11079,10475,604,5.5
28119,MS,Quitman,2621,2366,255,9.7
28121,MS,Rankin,75055,72093,2962,3.9
28123,MS,Scott,13281,12673,608,4.6
28125,MS,Sharkey,1716,1566,150,8.7
28127,MS,Simpson,10946,10354,592,5.4
28129,MS,Smith,6747,6393,354,5.2
28131,MS,Stone,6502,6066,436,6.7
28133,MS,Sunflower,8351,7577,774,9.3
28135,MS,Tallahatchie,5743,5355,388,6.8
28137,MS,Tate,12099,11393,706,5.8
28139,MS,Tippah,9410,8889,521,5.5
28141,MS,Tishomingo,8267,7815,452,5.5
28143,MS,Tunica,4616,4288,328,7.1
28145,MS,Union,13679,13076,603,4.4
28147,MS,Walthall,5042,4655,387,7.7
28149,MS,Warren,20836,19522,1314,6.3
28151,MS,Washington,17783,16188,1595,9
28153,MS,Wayne,7545,6995,550,7.3
28155,MS,Webster,3910,3667,243,6.2
28157,MS,Wilkinson,2839,2551,288,10.1
28159,MS,Winston,7115,6612,503,7.1
28161,MS,Yalobusha,4894,4588,306,6.3
28163,MS,Yazoo,9259,8578,681,7.4
29001,MO,Adair,10387,9796,591,5.7
29003,MO,Andrew,10046,9671,375,3.7
29005,MO,Atchison,2845,2715,130,4.6
29007,MO,Audrain,11151,10674,477,4.3
29009,MO,Barry,15214,14529,685,4.5
29011,MO,Barton,5327,5048,279,5.2
29013,MO,Bates,8168,7730,438,5.4
29015,MO,Benton,7267,6826,441,6.1
29017,MO,Bollinger,5468,5181,287,5.2
29019,MO,Boone,98295,95049,3246,3.3
29021,MO,Buchanan,46761,44845,1916,4.1
29023,MO,Butler,18823,17743,1080,5.7
29025,MO,Caldwell,4480,4269,211,4.7
29027,MO,Callaway,21855,20956,899,4.1
29029,MO,Camden,18747,17659,1088,5.8
29031,MO,Cape Girardeau,40818,39043,1775,4.3
29033,MO,Carroll,4775,4518,257,5.4
29035,MO,Carter,2546,2365,181,7.1
29037,MO,Cass,54589,52318,2271,4.2
29039,MO,Cedar,5804,5514,290,5
29041,MO,Chariton,3861,3693,168,4.4
29043,MO,Christian,43419,41711,1708,3.9
29045,MO,Clark,3376,3127,249,7.4
29047,MO,Clay,134195,128947,5248,3.9
29049,MO,Clinton,11027,10560,467,4.2
29051,MO,Cole,39481,38071,1410,3.6
29053,MO,Cooper,7492,7123,369,4.9
29055,MO,Crawford,10844,10263,581,5.4
29057,MO,Dade,3591,3431,160,4.5
29059,MO,Dallas,6966,6583,383,5.5
29061,MO,Daviess,4122,3962,160,3.9
29063,MO,DeKalb,5091,4868,223,4.4
29065,MO,Dent,6212,5876,336,5.4
29067,MO,Douglas,5090,4779,311,6.1
29069,MO,Dunklin,12856,11795,1061,8.3
29071,MO,Franklin,52747,50440,2307,4.4
29073,MO,Gasconade,7711,7378,333,4.3
29075,MO,Gentry,3593,3459,134,3.7
29077,MO,Greene,148797,143137,5660,3.8
29079,MO,Grundy,4910,4685,225,4.6
29081,MO,Harrison,3978,3810,168,4.2
29083,MO,Henry,9906,9410,496,5
29085,MO,Hickory,3701,3492,209,5.6
29087,MO,Holt,2689,2601,88,3.3
29089,MO,Howard,5038,4814,224,4.4
29091,MO,Howell,16140,15114,1026,6.4
29093,MO,Iron,3720,3453,267,7.2
29095,MO,Jackson,364728,346001,18727,5.1
29097,MO,Jasper,57819,55408,2411,4.2
29099,MO,Jefferson,117804,112724,5080,4.3
29101,MO,Johnson,23218,22076,1142,4.9
29103,MO,Knox,1986,1914,72,3.6
29105,MO,Laclede,16183,15299,884,5.5
29107,MO,Lafayette,17217,16472,745,4.3
29109,MO,Lawrence,17813,17032,781,4.4
29111,MO,Lewis,5145,4912,233,4.5
29113,MO,Lincoln,27268,26041,1227,4.5
29115,MO,Linn,5280,4925,355,6.7
29117,MO,Livingston,7360,7072,288,3.9
29119,MO,McDonald,10490,10033,457,4.4
29121,MO,Macon,7625,7260,365,4.8
29123,MO,Madison,5486,5184,302,5.5
29125,MO,Maries,3916,3718,198,5.1
29127,MO,Marion,14594,13968,626,4.3
29129,MO,Mercer,1932,1843,89,4.6
29131,MO,Miller,11900,11283,617,5.2
29133,MO,Mississippi,6224,5810,414,6.7
29135,MO,Moniteau,7483,7157,326,4.4
29137,MO,Monroe,4168,3966,202,4.8
29139,MO,Montgomery,5757,5493,264,4.6
29141,MO,Morgan,7978,7509,469,5.9
29143,MO,New Madrid,8255,7486,769,9.3
29145,MO,Newton,28261,27024,1237,4.4
29147,MO,Nodaway,10868,10359,509,4.7
29149,MO,Oregon,4121,3873,248,6
29151,MO,Osage,7237,6990,247,3.4
29153,MO,Ozark,3636,3371,265,7.3
29155,MO,Pemiscot,7043,6416,627,8.9
29157,MO,Perry,10094,9733,361,3.6
29159,MO,Pettis,20656,19634,1022,4.9
29161,MO,Phelps,19536,18605,931,4.8
29163,MO,Pike,8077,7712,365,4.5
29165,MO,Platte,56790,54728,2062,3.6
29167,MO,Polk,14244,13548,696,4.9
29169,MO,Pulaski,14499,13710,789,5.4
29171,MO,Putnam,2457,2345,112,4.6
29173,MO,Ralls,5635,5408,227,4
29175,MO,Randolph,10509,9956,553,5.3
29177,MO,Ray,11163,10612,551,4.9
29179,MO,Reynolds,2688,2513,175,6.5
29181,MO,Ripley,5344,4966,378,7.1
29183,MO,St. Charles,221460,213663,7797,3.5
29185,MO,St. Clair,3923,3676,247,6.3
29186,MO,Ste. Genevieve,9003,8583,420,4.7
29187,MO,St. Francois,26280,24828,1452,5.5
29189,MO,St. Louis,532450,509958,22492,4.2
29195,MO,Saline,10755,10252,503,4.7
29197,MO,Schuyler,1910,1788,122,6.4
29199,MO,Scotland,2459,2357,102,4.1
29201,MO,Scott,20003,18855,1148,5.7
29203,MO,Shannon,3331,3086,245,7.4
29205,MO,Shelby,3075,2946,129,4.2
29207,MO,Stoddard,13320,12465,855,6.4
29209,MO,Stone,13448,12506,942,7
29211,MO,Sullivan,2776,2615,161,5.8
29213,MO,Taney,26367,24415,1952,7.4
29215,MO,Texas,9337,8751,586,6.3
29217,MO,Vernon,9621,9154,467,4.9
29219,MO,Warren,17524,16789,735,4.2
29221,MO,Washington,10357,9699,658,6.4
29223,MO,Wayne,5668,5364,304,5.4
29225,MO,Webster,16926,16092,834,4.9
29227,MO,Worth,1213,1177,36,3
29229,MO,Wright,7616,7164,452,5.9
29510,MO,St. Louis city,157634,149016,8618,5.5
30001,MT,Beaverhead,5074,4906,168,3.3
30003,MT,Big Horn,5536,5135,401,7.2
30005,MT,Blaine,2371,2263,108,4.6
30007,MT,Broadwater,2552,2427,125,4.9
30009,MT,Carbon,5421,5208,213,3.9
30011,MT,Carter,697,678,19,2.7
30013,MT,Cascade,37812,36313,1499,4
30015,MT,Chouteau,2515,2421,94,3.7
30017,MT,Custer,6242,6022,220,3.5
30019,MT,Daniels,936,912,24,2.6
30021,MT,Dawson,4605,4429,176,3.8
30023,MT,Deer Lodge,5301,5100,201,3.8
30025,MT,Fallon,1813,1747,66,3.6
30027,MT,Fergus,5768,5542,226,3.9
30029,MT,Flathead,45973,43409,2564,5.6
30031,MT,Gallatin,62146,60399,1747,2.8
30033,MT,Garfield,764,742,22,2.9
30035,MT,Glacier,5820,5323,497,8.5
30037,MT,Golden Valley,379,362,17,4.5
30039,MT,Granite,1632,1536,96,5.9
30041,MT,Hill,7802,7466,336,4.3
30043,MT,Jefferson,5673,5412,261,4.6
30045,MT,Judith Basin,933,901,32,3.4
30047,MT,Lake,13085,12466,619,4.7
30049,MT,Lewis and Clark,35206,34045,1161,3.3
30051,MT,Liberty,989,958,31,3.1
30053,MT,Lincoln,7931,7218,713,9
30055,MT,McCone,1043,1023,20,1.9
30057,MT,Madison,4415,4249,166,3.8
30059,MT,Meagher,916,879,37,4
30061,MT,Mineral,1688,1560,128,7.6
30063,MT,Missoula,61420,59118,2302,3.7
30065,MT,Musselshell,2294,2177,117,5.1
30067,MT,Park,8412,8052,360,4.3
30069,MT,Petroleum,277,264,13,4.7
30071,MT,Phillips,1936,1834,102,5.3
30073,MT,Pondera,2865,2745,120,4.2
30075,MT,Powder River,1068,1043,25,2.3
30077,MT,Powell,2869,2725,144,5
30079,MT,Prairie,527,509,18,3.4
30081,MT,Ravalli,19580,18641,939,4.8
30083,MT,Richland,6215,5907,308,5
30085,MT,Roosevelt,4688,4439,249,5.3
30087,MT,Rosebud,4109,3884,225,5.5
30089,MT,Sanders,4756,4388,368,7.7
30091,MT,Sheridan,1961,1897,64,3.3
30093,MT,Silver Bow,17197,16462,735,4.3
30095,MT,Stillwater,4812,4621,191,4
30097,MT,Sweet Grass,1797,1742,55,3.1
30099,MT,Teton,2830,2728,102,3.6
30101,MT,Toole,2227,2150,77,3.5
30103,MT,Treasure,353,338,15,4.2
30105,MT,Valley,4406,4257,149,3.4
30107,MT,Wheatland,797,757,40,5
30109,MT,Wibaux,513,493,20,3.9
30111,MT,Yellowstone,81210,78293,2917,3.6
31001,NE,Adams,16640,16120,520,3.1
31003,NE,Antelope,3589,3496,93,2.6
31005,NE,Arthur,227,214,13,5.7
31007,NE,Banner,416,402,14,3.4
31009,NE,Blaine,265,253,12,4.5
31011,NE,Boone,3000,2922,78,2.6
31013,NE,Box Butte,5638,5436,202,3.6
31015,NE,Boyd,1098,1065,33,3
31017,NE,Brown,1378,1328,50,3.6
31019,NE,Buffalo,27191,26512,679,2.5
31021,NE,Burt,3543,3413,130,3.7
31023,NE,Butler,4622,4474,148,3.2
31025,NE,Cass,13131,12691,440,3.4
31027,NE,Cedar,4565,4449,116,2.5
31029,NE,Chase,2289,2242,47,2.1
31031,NE,Cherry,3468,3390,78,2.2
31033,NE,Cheyenne,5447,5294,153,2.8
31035,NE,Clay,3319,3216,103,3.1
31037,NE,Colfax,5546,5389,157,2.8
31039,NE,Cuming,4711,4576,135,2.9
31041,NE,Custer,6345,6197,148,2.3
31043,NE,Dakota,10897,10446,451,4.1
31045,NE,Dawes,5209,5056,153,2.9
31047,NE,Dawson,12952,12570,382,2.9
31049,NE,Deuel,1061,1033,28,2.6
31051,NE,Dixon,3065,2964,101,3.3
31053,NE,Dodge,19112,18527,585,3.1
31055,NE,Douglas,287729,278212,9517,3.3
31057,NE,Dundy,1195,1169,26,2.2
31059,NE,Fillmore,3180,3093,87,2.7
31061,NE,Franklin,1500,1455,45,3
31063,NE,Frontier,1568,1524,44,2.8
31065,NE,Furnas,2712,2637,75,2.8
31067,NE,Gage,11040,10679,361,3.3
31069,NE,Garden,1186,1147,39,3.3
31071,NE,Garfield,1155,1126,29,2.5
31073,NE,Gosper,1055,1028,27,2.6
31075,NE,Grant,452,442,10,2.2
31077,NE,Greeley,1233,1195,38,3.1
31079,NE,Hall,31377,30230,1147,3.7
31081,NE,Hamilton,4648,4519,129,2.8
31083,NE,Harlan,1756,1712,44,2.5
31085,NE,Hayes,589,575,14,2.4
31087,NE,Hitchcock,1305,1258,47,3.6
31089,NE,Holt,5854,5710,144,2.5
31091,NE,Hooker,391,377,14,3.6
31093,NE,Howard,3296,3188,108,3.3
31095,NE,Jefferson,4217,4116,101,2.4
31097,NE,Johnson,2090,2024,66,3.2
31099,NE,Kearney,3737,3649,88,2.4
31101,NE,Keith,4613,4480,133,2.9
31103,NE,Keya Paha,619,606,13,2.1
31105,NE,Kimball,1970,1890,80,4.1
31107,NE,Knox,4715,4571,144,3.1
31109,NE,Lancaster,168872,164201,4671,2.8
31111,NE,Lincoln,18692,18119,573,3.1
31113,NE,Logan,482,469,13,2.7
31115,NE,Loup,395,382,13,3.3
31117,NE,McPherson,463,452,11,2.4
31119,NE,Madison,19140,18615,525,2.7
31121,NE,Merrick,4030,3885,145,3.6
31123,NE,Morrill,2646,2562,84,3.2
31125,NE,Nance,1997,1943,54,2.7
31127,NE,Nemaha,3612,3482,130,3.6
31129,NE,Nuckolls,2364,2296,68,2.9
31131,NE,Otoe,8252,7973,279,3.4
31133,NE,Pawnee,1652,1615,37,2.2
31135,NE,Perkins,1818,1779,39,2.1
31137,NE,Phelps,4924,4801,123,2.5
31139,NE,Pierce,4142,4033,109,2.6
31141,NE,Platte,16957,16369,588,3.5
31143,NE,Polk,2879,2803,76,2.6
31145,NE,Red Willow,5970,5802,168,2.8
31147,NE,Richardson,4233,4097,136,3.2
31149,NE,Rock,890,867,23,2.6
31151,NE,Saline,7343,7117,226,3.1
31153,NE,Sarpy,91966,89296,2670,2.9
31155,NE,Saunders,10863,10531,332,3.1
31157,NE,Scotts Bluff,18825,18169,656,3.5
31159,NE,Seward,8744,8495,249,2.8
31161,NE,Sheridan,2735,2657,78,2.9
31163,NE,Sherman,1714,1660,54,3.2
31165,NE,Sioux,783,762,21,2.7
31167,NE,Stanton,3438,3348,90,2.6
31169,NE,Thayer,2901,2830,71,2.4
31171,NE,Thomas,447,433,14,3.1
31173,NE,Thurston,2975,2833,142,4.8
31175,NE,Valley,2090,2032,58,2.8
31177,NE,Washington,11096,10742,354,3.2
31179,NE,Wayne,5619,5470,149,2.7
31181,NE,Webster,1710,1657,53,3.1
31183,NE,Wheeler,565,553,12,2.1
31185,NE,York,7316,7119,197,2.7
32001,NV,Churchill,10703,10125,578,5.4
32003,NV,Clark,1046103,984714,61389,5.9
32005,NV,Douglas,22339,21084,1255,5.6
32007,NV,Elko,27037,25830,1207,4.5
32009,NV,Esmeralda,524,500,24,4.6
32011,NV,Eureka,991,945,46,4.6
32013,NV,Humboldt,8336,7894,442,5.3
32015,NV,Lander,3162,2966,196,6.2
32017,NV,Lincoln,2030,1924,106,5.2
32019,NV,Lyon,21773,20171,1602,7.4
32021,NV,Mineral,1983,1855,128,6.5
32023,NV,Nye,16164,14984,1180,7.3
32027,NV,Pershing,2530,2384,146,5.8
32029,NV,Storey,1901,1781,120,6.3
32031,NV,Washoe,229320,217784,11536,5
32033,NV,White Pine,4565,4356,209,4.6
32510,NV,Carson City,24684,23176,1508,6.1
33001,NH,Belknap,31380,30489,891,2.8
33003,NH,Carroll,23667,22968,699,3
33005,NH,Cheshire,41393,40259,1134,2.7
33007,NH,Coos,14639,14088,551,3.8
33009,NH,Grafton,48738,47586,1152,2.4
33011,NH,Hillsborough,231936,224926,7010,3
33013,NH,Merrimack,81909,79817,2092,2.6
33015,NH,Rockingham,181666,176168,5498,3
33017,NH,Strafford,72400,70554,1846,2.5
33019,NH,Sullivan,23588,23039,549,2.3
34001,NJ,Atlantic,122574,113483,9091,7.4
34003,NJ,Bergen,478787,458743,20044,4.2
34005,NJ,Burlington,230271,219995,10276,4.5
34007,NJ,Camden,252713,238823,13890,5.5
34009,NJ,Cape May,46661,42076,4585,9.8
34011,NJ,Cumberland,66335,61374,4961,7.5
34013,NJ,Essex,367908,345779,22129,6
34015,NJ,Gloucester,148968,141431,7537,5.1
34017,NJ,Hudson,359152,342335,16817,4.7
34019,NJ,Hunterdon,64215,61793,2422,3.8
34021,NJ,Mercer,196995,188408,8587,4.4
34023,NJ,Middlesex,436159,416825,19334,4.4
34025,NJ,Monmouth,326476,311922,14554,4.5
34027,NJ,Morris,257919,247799,10120,3.9
34029,NJ,Ocean,267872,253889,13983,5.2
34031,NJ,Passaic,243533,228488,15045,6.2
34033,NJ,Salem,30010,28092,1918,6.4
34035,NJ,Somerset,171907,164924,6983,4.1
34037,NJ,Sussex,74770,71240,3530,4.7
34039,NJ,Union,275097,260860,14237,5.2
34041,NJ,Warren,56365,53782,2583,4.6
35001,NM,Bernalillo,326580,307771,18809,5.8
35003,NM,Catron,1204,1107,97,8.1
35005,NM,Chaves,28020,26156,1864,6.7
35006,NM,Cibola,9296,8540,756,8.1
35007,NM,Colfax,5825,5478,347,6
35009,NM,Curry,21959,20859,1100,5
35011,NM,De Baca,832,793,39,4.7
35013,NM,Dona Ana,95562,88772,6790,7.1
35015,NM,Eddy,28675,26827,1848,6.4
35017,NM,Grant,12455,11659,796,6.4
35019,NM,Guadalupe,1690,1582,108,6.4
35021,NM,Harding,277,258,19,6.9
35023,NM,Hidalgo,2201,2080,121,5.5
35025,NM,Lea,27718,25184,2534,9.1
35027,NM,Lincoln,8636,8127,509,5.9
35028,NM,Los Alamos,8792,8423,369,4.2
35029,NM,Luna,10768,9218,1550,14.4
35031,NM,McKinley,24367,22106,2261,9.3
35033,NM,Mora,2236,2043,193,8.6
35035,NM,Otero,25462,23934,1528,6
35037,NM,Quay,3208,2992,216,6.7
35039,NM,Rio Arriba,16750,15509,1241,7.4
35041,NM,Roosevelt,8064,7608,456,5.7
35043,NM,Sandoval,64067,59884,4183,6.5
35045,NM,San Juan,54194,49479,4715,8.7
35047,NM,San Miguel,11083,10238,845,7.6
35049,NM,Santa Fe,73464,69614,3850,5.2
35051,NM,Sierra,4059,3719,340,8.4
35053,NM,Socorro,6676,6190,486,7.3
35055,NM,Taos,14932,13685,1247,8.4
35057,NM,Torrance,5504,5007,497,9
35059,NM,Union,1893,1818,75,4
35061,NM,Valencia,29900,27764,2136,7.1
36001,NY,Albany,158283,151867,6416,4.1
36003,NY,Allegany,20033,18768,1265,6.3
36005,NY,Bronx,608798,565436,43362,7.1
36007,NY,Broome,85773,81119,4654,5.4
36009,NY,Cattaraugus,34815,32737,2078,6
36011,NY,Cayuga,36657,34804,1853,5.1
36013,NY,Chautauqua,56060,52807,3253,5.8
36015,NY,Chemung,36168,34099,2069,5.7
36017,NY,Chenango,22808,21653,1155,5.1
36019,NY,Clinton,35761,33845,1916,5.4
36021,NY,Columbia,31430,30272,1158,3.7
36023,NY,Cortland,22960,21652,1308,5.7
36025,NY,Delaware,19201,18142,1059,5.5
36027,NY,Dutchess,142889,136948,5941,4.2
36029,NY,Erie,444647,422760,21887,4.9
36031,NY,Essex,17220,16300,920,5.3
36033,NY,Franklin,19770,18649,1121,5.7
36035,NY,Fulton,23196,21870,1326,5.7
36037,NY,Genesee,29697,28336,1361,4.6
36039,NY,Greene,20540,19503,1037,5
36041,NY,Hamilton,2361,2208,153,6.5
36043,NY,Herkimer,28138,26601,1537,5.5
36045,NY,Jefferson,45611,42764,2847,6.2
36047,NY,Kings,1217585,1152734,64851,5.3
36049,NY,Lewis,11728,10941,787,6.7
36051,NY,Livingston,31001,29471,1530,4.9
36053,NY,Madison,32663,30944,1719,5.3
36055,NY,Monroe,362830,345801,17029,4.7
36057,NY,Montgomery,22282,21008,1274,5.7
36059,NY,Nassau,699134,671823,27311,3.9
36061,NY,New York,916777,875013,41764,4.6
36063,NY,Niagara,100111,94277,5834,5.8
36065,NY,Oneida,101533,96620,4913,4.8
36067,NY,Onondaga,220909,210943,9966,4.5
36069,NY,Ontario,55001,52630,2371,4.3
36071,NY,Orange,178694,170975,7719,4.3
36073,NY,Orleans,17728,16715,1013,5.7
36075,NY,Oswego,53235,49800,3435,6.5
36077,NY,Otsego,28170,26787,1383,4.9
36079,NY,Putnam,50626,48612,2014,4
36081,NY,Queens,1161534,1108791,52743,4.5
36083,NY,Rensselaer,81464,77981,3483,4.3
36085,NY,Richmond,221377,209784,11593,5.2
36087,NY,Rockland,152331,145961,6370,4.2
36089,NY,St. Lawrence,43305,40451,2854,6.6
36091,NY,Saratoga,117328,112854,4474,3.8
36093,NY,Schenectady,75692,72414,3278,4.3
36095,NY,Schoharie,14704,13907,797,5.4
36097,NY,Schuyler,8266,7769,497,6
36099,NY,Seneca,15469,14733,736,4.8
36101,NY,Steuben,43110,40600,2510,5.8
36103,NY,Suffolk,773132,739429,33703,4.4
36105,NY,Sullivan,33993,32369,1624,4.8
36107,NY,Tioga,22987,21808,1179,5.1
36109,NY,Tompkins,50303,48211,2092,4.2
36111,NY,Ulster,88055,84163,3892,4.4
36113,NY,Warren,31951,30270,1681,5.3
36115,NY,Washington,28312,26993,1319,4.7
36117,NY,Wayne,43937,41749,2188,5
36119,NY,Westchester,477240,456792,20448,4.3
36121,NY,Wyoming,18085,17121,964,5.3
36123,NY,Yates,11703,11186,517,4.4
37001,NC,Alamance,78947,75206,3741,4.7
37003,NC,Alexander,17835,17077,758,4.3
37005,NC,Alleghany,4426,4183,243,5.5
37007,NC,Anson,10660,10043,617,5.8
37009,NC,Ashe,12509,11909,600,4.8
37011,NC,Avery,7576,7195,381,5
37013,NC,Beaufort,20308,19152,1156,5.7
37015,NC,Bertie,8437,7879,558,6.6
37017,NC,Bladen,14570,13563,1007,6.9
37019,NC,Brunswick,49708,46502,3206,6.4
37021,NC,Buncombe,134377,129183,5194,3.9
37023,NC,Burke,39859,37920,1939,4.9
37025,NC,Cabarrus,101188,96565,4623,4.6
37027,NC,Caldwell,35900,34037,1863,5.2
37029,NC,Camden,4659,4419,240,5.2
37031,NC,Carteret,31575,29946,1629,5.2
37033,NC,Caswell,9691,9164,527,5.4
37035,NC,Catawba,76892,73252,3640,4.7
37037,NC,Chatham,34527,33063,1464,4.2
37039,NC,Cherokee,11146,10513,633,5.7
37041,NC,Chowan,5602,5244,358,6.4
37043,NC,Clay,4052,3830,222,5.5
37045,NC,Cleveland,46817,44257,2560,5.5
37047,NC,Columbus,22598,21148,1450,6.4
37049,NC,Craven,41761,39575,2186,5.2
37051,NC,Cumberland,127349,119201,8148,6.4
37053,NC,Currituck,13154,12486,668,5.1
37055,NC,Dare,20005,18653,1352,6.8
37057,NC,Davidson,79522,75688,3834,4.8
37059,NC,Davie,20172,19264,908,4.5
37061,NC,Duplin,26507,25093,1414,5.3
37063,NC,Durham,162119,154819,7300,4.5
37065,NC,Edgecombe,22423,20477,1946,8.7
37067,NC,Forsyth,182659,173770,8889,4.9
37069,NC,Franklin,29348,27815,1533,5.2
37071,NC,Gaston,105658,100022,5636,5.3
37073,NC,Gates,5191,4925,266,5.1
37075,NC,Graham,3102,2828,274,8.8
37077,NC,Granville,29284,28018,1266,4.3
37079,NC,Greene,9525,9021,504,5.3
37081,NC,Guilford,258494,244964,13530,5.2
37083,NC,Halifax,20685,19046,1639,7.9
37085,NC,Harnett,51464,48484,2980,5.8
37087,NC,Haywood,28487,27192,1295,4.5
37089,NC,Henderson,52301,50070,2231,4.3
37091,NC,Hertford,9316,8704,612,6.6
37093,NC,Hoke,19917,18604,1313,6.6
37095,NC,Hyde,2110,1910,200,9.5
37097,NC,Iredell,84567,80503,4064,4.8
37099,NC,Jackson,18832,17809,1023,5.4
37101,NC,Johnston,91595,87307,4288,4.7
37103,NC,Jones,4515,4277,238,5.3
37105,NC,Lee,26232,24690,1542,5.9
37107,NC,Lenoir,27653,26031,1622,5.9
37109,NC,Lincoln,41097,39159,1938,4.7
37111,NC,McDowell,21016,20007,1009,4.8
37113,NC,Macon,15219,14399,820,5.4
37115,NC,Madison,9702,9229,473,4.9
37117,NC,Martin,9815,9152,663,6.8
37119,NC,Mecklenburg,583509,555857,27652,4.7
37121,NC,Mitchell,6189,5810,379,6.1
37123,NC,Montgomery,11701,11097,604,5.2
37125,NC,Moore,39513,37531,1982,5
37127,NC,Nash,43930,41041,2889,6.6
37129,NC,New Hanover,116062,110582,5480,4.7
37131,NC,Northampton,7815,7248,567,7.3
37133,NC,Onslow,63722,60212,3510,5.5
37135,NC,Orange,74934,71762,3172,4.2
37137,NC,Pamlico,5409,5123,286,5.3
37139,NC,Pasquotank,17398,16304,1094,6.3
37141,NC,Pender,26854,25432,1422,5.3
37143,NC,Perquimans,5101,4773,328,6.4
37145,NC,Person,18036,17047,989,5.5
37147,NC,Pitt,88214,83301,4913,5.6
37149,NC,Polk,8826,8416,410,4.6
37151,NC,Randolph,66896,63601,3295,4.9
37153,NC,Richmond,16791,15629,1162,6.9
37155,NC,Robeson,50555,46543,4012,7.9
37157,NC,Rockingham,40856,38547,2309,5.7
37159,NC,Rowan,64236,60662,3574,5.6
37161,NC,Rutherford,24812,23152,1660,6.7
37163,NC,Sampson,29517,27906,1611,5.5
37165,NC,Scotland,11637,10574,1063,9.1
37167,NC,Stanly,29289,27930,1359,4.6
37169,NC,Stokes,21875,20829,1046,4.8
37171,NC,Surry,33526,31923,1603,4.8
37173,NC,Swain,7118,6684,434,6.1
37175,NC,Transylvania,13960,13280,680,4.9
37177,NC,Tyrrell,1530,1401,129,8.4
37179,NC,Union,115777,110677,5100,4.4
37181,NC,Vance,18005,16717,1288,7.2
37183,NC,Wake,556722,532808,23914,4.3
37185,NC,Warren,7143,6621,522,7.3
37187,NC,Washington,4866,4505,361,7.4
37189,NC,Watauga,27950,26694,1256,4.5
37191,NC,Wayne,53558,50436,3122,5.8
37193,NC,Wilkes,30205,28758,1447,4.8
37195,NC,Wilson,36489,33515,2974,8.2
37197,NC,Yadkin,17612,16840,772,4.4
37199,NC,Yancey,7479,7093,386,5.2
38001,ND,Adams,1133,1104,29,2.6
38003,ND,Barnes,5623,5444,179,3.2
38005,ND,Benson,2435,2337,98,4
38007,ND,Billings,438,425,13,3
38009,ND,Bottineau,3230,3080,150,4.6
38011,ND,Bowman,1837,1797,40,2.2
38013,ND,Burke,1146,1094,52,4.5
38015,ND,Burleigh,50638,49334,1304,2.6
38017,ND,Cass,100237,98000,2237,2.2
38019,ND,Cavalier,2117,2061,56,2.6
38021,ND,Dickey,2547,2498,49,1.9
38023,ND,Divide,1684,1640,44,2.6
38025,ND,Dunn,3249,3147,102,3.1
38027,ND,Eddy,1279,1224,55,4.3
38029,ND,Emmons,1585,1516,69,4.4
38031,ND,Foster,1686,1636,50,3
38033,ND,Golden Valley,971,945,26,2.7
38035,ND,Grand Forks,38826,37912,914,2.4
38037,ND,Grant,1297,1258,39,3
38039,ND,Griggs,1160,1127,33,2.8
38041,ND,Hettinger,1540,1494,46,3
38043,ND,Kidder,1376,1324,52,3.8
38045,ND,LaMoure,2316,2261,55,2.4
38047,ND,Logan,959,926,33,3.4
38049,ND,McHenry,3377,3212,165,4.9
38051,ND,McIntosh,1241,1203,38,3.1
38053,ND,McKenzie,7949,7650,299,3.8
38055,ND,McLean,5070,4894,176,3.5
38057,ND,Mercer,4654,4450,204,4.4
38059,ND,Morton,16798,16252,546,3.3
38061,ND,Mountrail,7133,6921,212,3
38063,ND,Nelson,1534,1482,52,3.4
38065,ND,Oliver,898,849,49,5.5
38067,ND,Pembina,3660,3477,183,5
38069,ND,Pierce,1899,1824,75,3.9
38071,ND,Ramsey,6148,5973,175,2.8
38073,ND,Ransom,2840,2776,64,2.3
38075,ND,Renville,1309,1258,51,3.9
38077,ND,Richland,8905,8662,243,2.7
38079,ND,Rolette,4986,4448,538,10.8
38081,ND,Sargent,2333,2288,45,1.9
38083,ND,Sheridan,737,695,42,5.7
38085,ND,Sioux,1339,1280,59,4.4
38087,ND,Slope,436,425,11,2.5
38089,ND,Stark,18090,17384,706,3.9
38091,ND,Steele,1075,1052,23,2.1
38093,ND,Stutsman,11082,10809,273,2.5
38095,ND,Towner,1332,1303,29,2.2
38097,ND,Traill,4600,4472,128,2.8
38099,ND,Walsh,5663,5449,214,3.8
38101,ND,Ward,33545,32166,1379,4.1
38103,ND,Wells,2192,2107,85,3.9
38105,ND,Williams,22636,21652,984,4.3
39001,OH,Adams,10942,10119,823,7.5
39003,OH,Allen,48262,45840,2422,5
39005,OH,Ashland,26258,24927,1331,5.1
39007,OH,Ashtabula,44220,41522,2698,6.1
39009,OH,Athens,28017,26223,1794,6.4
39011,OH,Auglaize,24622,23704,918,3.7
39013,OH,Belmont,31008,28694,2314,7.5
39015,OH,Brown,19492,18363,1129,5.8
39017,OH,Butler,189443,180906,8537,4.5
39019,OH,Carroll,13437,12517,920,6.8
39021,OH,Champaign,19882,18987,895,4.5
39023,OH,Clark,63577,60244,3333,5.2
39025,OH,Clermont,103911,99294,4617,4.4
39027,OH,Clinton,17169,16169,1000,5.8
39029,OH,Columbiana,48381,45146,3235,6.7
39031,OH,Coshocton,14993,13930,1063,7.1
39033,OH,Crawford,19167,18013,1154,6
39035,OH,Cuyahoga,613975,579779,34196,5.6
39037,OH,Darke,26376,25289,1087,4.1
39039,OH,Defiance,18380,17473,907,4.9
39041,OH,Delaware,104863,101072,3791,3.6
39043,OH,Erie,37419,35365,2054,5.5
39045,OH,Fairfield,75958,72676,3282,4.3
39047,OH,Fayette,14487,13846,641,4.4
39049,OH,Franklin,666877,639357,27520,4.1
39051,OH,Fulton,22677,21622,1055,4.7
39053,OH,Gallia,12126,11299,827,6.8
39055,OH,Geauga,49190,46983,2207,4.5
39057,OH,Greene,81100,77572,3528,4.4
39059,OH,Guernsey,18888,17550,1338,7.1
39061,OH,Hamilton,404955,387023,17932,4.4
39063,OH,Hancock,41465,39935,1530,3.7
39065,OH,Hardin,14378,13659,719,5
39067,OH,Harrison,6969,6436,533,7.6
39069,OH,Henry,13605,12878,727,5.3
39071,OH,Highland,16930,15856,1074,6.3
39073,OH,Hocking,13011,12284,727,5.6
39075,OH,Holmes,20993,20236,757,3.6
39077,OH,Huron,28114,26284,1830,6.5
39079,OH,Jackson,12800,11794,1006,7.9
39081,OH,Jefferson,28904,26487,2417,8.4
39083,OH,Knox,31232,29786,1446,4.6
39085,OH,Lake,124922,118779,6143,4.9
39087,OH,Lawrence,24751,23139,1612,6.5
39089,OH,Licking,88252,84380,3872,4.4
39091,OH,Logan,23323,22345,978,4.2
39093,OH,Lorain,152716,143518,9198,6
39095,OH,Lucas,210421,199510,10911,5.2
39097,OH,Madison,20339,19537,802,3.9
39099,OH,Mahoning,105950,99182,6768,6.4
39101,OH,Marion,27740,26330,1410,5.1
39103,OH,Medina,96165,91913,4252,4.4
39105,OH,Meigs,8953,8189,764,8.5
39107,OH,Mercer,23427,22661,766,3.3
39109,OH,Miami,53014,50703,2311,4.4
39111,OH,Monroe,5320,4728,592,11.1
39113,OH,Montgomery,250063,237713,12350,4.9
39115,OH,Morgan,6752,6192,560,8.3
39117,OH,Morrow,16767,15920,847,5.1
39119,OH,Muskingum,39735,37339,2396,6
39121,OH,Noble,4892,4465,427,8.7
39123,OH,Ottawa,21030,19672,1358,6.5
39125,OH,Paulding,8876,8468,408,4.6
39127,OH,Perry,15889,14876,1013,6.4
39129,OH,Pickaway,26203,24938,1265,4.8
39131,OH,Pike,10807,9995,812,7.5
39133,OH,Portage,87129,82748,4381,5
39135,OH,Preble,21019,20017,1002,4.8
39137,OH,Putnam,18902,18209,693,3.7
39139,OH,Richland,53413,50450,2963,5.5
39141,OH,Ross,33840,31972,1868,5.5
39143,OH,Sandusky,31026,29561,1465,4.7
39145,OH,Scioto,29875,27562,2313,7.7
39147,OH,Seneca,27151,25820,1331,4.9
39149,OH,Shelby,24074,23074,1000,4.2
39151,OH,Stark,186472,176293,10179,5.5
39153,OH,Summit,272399,258493,13906,5.1
39155,OH,Trumbull,90427,84306,6121,6.8
39157,OH,Tuscarawas,45021,42431,2590,5.8
39159,OH,Union,27796,26733,1063,3.8
39161,OH,Van Wert,14306,13727,579,4
39163,OH,Vinton,5455,5070,385,7.1
39165,OH,Warren,114608,109844,4764,4.2
39167,OH,Washington,27778,25837,1941,7
39169,OH,Wayne,61223,58782,2441,4
39171,OH,Williams,19026,18166,860,4.5
39173,OH,Wood,70655,67701,2954,4.2
39175,OH,Wyandot,12676,12205,471,3.7
40001,OK,Adair,8162,7686,476,5.8
40003,OK,Alfalfa,2970,2871,99,3.3
40005,OK,Atoka,5066,4733,333,6.6
40007,OK,Beaver,2889,2799,90,3.1
40009,OK,Beckham,11044,10249,795,7.2
40011,OK,Blaine,4395,4233,162,3.7
40013,OK,Bryan,19529,18686,843,4.3
40015,OK,Caddo,11935,11302,633,5.3
40017,OK,Canadian,69479,66705,2774,4
40019,OK,Carter,22742,21564,1178,5.2
40021,OK,Cherokee,19307,18243,1064,5.5
40023,OK,Choctaw,5761,5321,440,7.6
40025,OK,Cimarron,1417,1382,35,2.5
40027,OK,Cleveland,139280,133958,5322,3.8
40029,OK,Coal,2323,2153,170,7.3
40031,OK,Comanche,49496,47212,2284,4.6
40033,OK,Cotton,2893,2754,139,4.8
40035,OK,Craig,6259,5956,303,4.8
40037,OK,Creek,31532,29698,1834,5.8
40039,OK,Custer,15212,14519,693,4.6
40041,OK,Delaware,17987,17106,881,4.9
40043,OK,Dewey,2678,2569,109,4.1
40045,OK,Ellis,2257,2171,86,3.8
40047,OK,Garfield,29026,27757,1269,4.4
40049,OK,Garvin,12727,12046,681,5.4
40051,OK,Grady,26117,24819,1298,5
40053,OK,Grant,3008,2911,97,3.2
40055,OK,Greer,2192,2030,162,7.4
40057,OK,Harmon,1293,1244,49,3.8
40059,OK,Harper,1912,1839,73,3.8
40061,OK,Haskell,4508,4135,373,8.3
40063,OK,Hughes,5520,5119,401,7.3
40065,OK,Jackson,11013,10529,484,4.4
40067,OK,Jefferson,2713,2519,194,7.2
40069,OK,Johnston,4378,4121,257,5.9
40071,OK,Kay,18965,17767,1198,6.3
40073,OK,Kingfisher,8457,8177,280,3.3
40075,OK,Kiowa,4113,3894,219,5.3
40077,OK,Latimer,3729,3407,322,8.6
40079,OK,Le Flore,19778,18412,1366,6.9
40081,OK,Lincoln,15896,15050,846,5.3
40083,OK,Logan,21598,20723,875,4.1
40085,OK,Love,6578,6371,207,3.1
40087,OK,McClain,18979,18198,781,4.1
40089,OK,McCurtain,14825,13764,1061,7.2
40091,OK,McIntosh,7069,6438,631,8.9
40093,OK,Major,3998,3833,165,4.1
40095,OK,Marshall,6622,6287,335,5.1
40097,OK,Mayes,19465,18470,995,5.1
40099,OK,Murray,6350,6064,286,4.5
40101,OK,Muskogee,29661,28043,1618,5.5
40103,OK,Noble,5766,5562,204,3.5
40105,OK,Nowata,4692,4406,286,6.1
40107,OK,Okfuskee,4558,4280,278,6.1
40109,OK,Oklahoma,375493,359384,16109,4.3
40111,OK,Okmulgee,16172,15010,1162,7.2
40113,OK,Osage,21092,19877,1215,5.8
40115,OK,Ottawa,14482,13754,728,5
40117,OK,Pawnee,7500,7002,498,6.6
40119,OK,Payne,38949,37501,1448,3.7
40121,OK,Pittsburg,17651,16566,1085,6.1
40123,OK,Pontotoc,18476,17723,753,4.1
40125,OK,Pottawatomie,33092,31563,1529,4.6
40127,OK,Pushmataha,4881,4525,356,7.3
40129,OK,Roger Mills,1813,1720,93,5.1
40131,OK,Rogers,44930,42674,2256,5
40133,OK,Seminole,9452,8798,654,6.9
40135,OK,Sequoyah,16861,15805,1056,6.3
40137,OK,Stephens,19048,17238,1810,9.5
40139,OK,Texas,9411,9092,319,3.4
40141,OK,Tillman,3315,3168,147,4.4
40143,OK,Tulsa,318576,303691,14885,4.7
40145,OK,Wagoner,36658,34904,1754,4.8
40147,OK,Washington,23960,22786,1174,4.9
40149,OK,Washita,5327,4958,369,6.9
40151,OK,Woods,5224,5056,168,3.2
40153,OK,Woodward,9528,8936,592,6.2
41001,OR,Baker,6955,6517,438,6.3
41003,OR,Benton,46803,44974,1829,3.9
41005,OR,Clackamas,212716,203489,9227,4.3
41007,OR,Clatsop,19026,18131,895,4.7
41009,OR,Columbia,23624,22185,1439,6.1
41011,OR,Coos,26446,24760,1686,6.4
41013,OR,Crook,9346,8699,647,6.9
41015,OR,Curry,9047,8437,610,6.7
41017,OR,Deschutes,89902,85535,4367,4.9
41019,OR,Douglas,45714,42852,2862,6.3
41021,OR,Gilliam,838,789,49,5.8
41023,OR,Grant,3109,2872,237,7.6
41025,OR,Harney,3425,3211,214,6.2
41027,OR,Hood River,13912,13338,574,4.1
41029,OR,Jackson,101428,95610,5818,5.7
41031,OR,Jefferson,9864,9213,651,6.6
41033,OR,Josephine,34296,32080,2216,6.5
41035,OR,Klamath,29235,27258,1977,6.8
41037,OR,Lake,3454,3234,220,6.4
41039,OR,Lane,178520,169463,9057,5.1
41041,OR,Lincoln,20904,19733,1171,5.6
41043,OR,Linn,56842,53606,3236,5.7
41045,OR,Malheur,12482,11794,688,5.5
41047,OR,Marion,157440,149485,7955,5.1
41049,OR,Morrow,5768,5489,279,4.8
41051,OR,Multnomah,444006,425266,18740,4.2
41053,OR,Polk,38336,36406,1930,5
41055,OR,Sherman,895,854,41,4.6
41057,OR,Tillamook,11643,11072,571,4.9
41059,OR,Umatilla,36023,34104,1919,5.3
41061,OR,Union,11979,11273,706,5.9
41063,OR,Wallowa,3316,3093,223,6.7
41065,OR,Wasco,13694,13038,656,4.8
41067,OR,Washington,313480,300651,12829,4.1
41069,OR,Wheeler,686,657,29,4.2
41071,OR,Yamhill,53203,50764,2439,4.6
42001,PA,Adams,55392,53195,2197,4
42003,PA,Allegheny,647442,613923,33519,5.2
42005,PA,Armstrong,33087,30609,2478,7.5
42007,PA,Beaver,85311,80035,5276,6.2
42009,PA,Bedford,24049,22643,1406,5.8
42011,PA,Berks,213186,202596,10590,5
42013,PA,Blair,60843,57635,3208,5.3
42015,PA,Bradford,30170,28201,1969,6.5
42017,PA,Bucks,340801,325087,15714,4.6
42019,PA,Butler,98598,93616,4982,5.1
42021,PA,Cambria,61337,57173,4164,6.8
42023,PA,Cameron,2231,2067,164,7.4
42025,PA,Carbon,31552,29672,1880,6
42027,PA,Centre,78925,75635,3290,4.2
42029,PA,Chester,280310,269460,10850,3.9
42031,PA,Clarion,18024,16916,1108,6.1
42033,PA,Clearfield,36302,33661,2641,7.3
42035,PA,Clinton,18552,17241,1311,7.1
42037,PA,Columbia,33892,32017,1875,5.5
42039,PA,Crawford,40496,38066,2430,6
42041,PA,Cumberland,130104,124828,5276,4.1
42043,PA,Dauphin,142086,135338,6748,4.7
42045,PA,Delaware,294152,279850,14302,4.9
42047,PA,Elk,16329,15430,899,5.5
42049,PA,Erie,133570,124886,8684,6.5
42051,PA,Fayette,58428,53700,4728,8.1
42053,PA,Forest,1890,1742,148,7.8
42055,PA,Franklin,77483,73493,3990,5.1
42057,PA,Fulton,7303,6842,461,6.3
42059,PA,Greene,17295,15957,1338,7.7
42061,PA,Huntingdon,19661,18289,1372,7
42063,PA,Indiana,40161,37241,2920,7.3
42065,PA,Jefferson,20699,19284,1415,6.8
42067,PA,Juniata,12198,11546,652,5.3
42069,PA,Lackawanna,106753,100722,6031,5.6
42071,PA,Lancaster,279791,268250,11541,4.1
42073,PA,Lawrence,41501,38716,2785,6.7
42075,PA,Lebanon,70572,67413,3159,4.5
42077,PA,Lehigh,188952,178860,10092,5.3
42079,PA,Luzerne,158706,148726,9980,6.3
42081,PA,Lycoming,58711,54823,3888,6.6
42083,PA,McKean,18488,17266,1222,6.6
42085,PA,Mercer,52527,49396,3131,6
42087,PA,Mifflin,20804,19615,1189,5.7
42089,PA,Monroe,81853,76748,5105,6.2
42091,PA,Montgomery,447345,428861,18484,4.1
42093,PA,Montour,9126,8737,389,4.3
42095,PA,Northampton,158771,150580,8191,5.2
42097,PA,Northumberland,43949,41207,2742,6.2
42099,PA,Perry,24281,23162,1119,4.6
42101,PA,Philadelphia/city,703277,655784,47493,6.8
42103,PA,Pike,24853,23266,1587,6.4
42105,PA,Potter,7379,6801,578,7.8
42107,PA,Schuylkill,67559,63388,4171,6.2
42109,PA,Snyder,20514,19556,958,4.7
42111,PA,Somerset,34171,31717,2454,7.2
42113,PA,Sullivan,2840,2636,204,7.2
42115,PA,Susquehanna,20862,19679,1183,5.7
42117,PA,Tioga,19863,18449,1414,7.1
42119,PA,Union,19778,18833,945,4.8
42121,PA,Venango,23710,21993,1717,7.2
42123,PA,Warren,19774,18692,1082,5.5
42125,PA,Washington,107247,100697,6550,6.1
42127,PA,Wayne,22518,21226,1292,5.7
42129,PA,Westmoreland,182780,172101,10679,5.8
42131,PA,Wyoming,14084,13211,873,6.2
42133,PA,York,234861,224026,10835,4.6
44001,RI,Bristol,26141,24931,1210,4.6
44003,RI,Kent,90748,86456,4292,4.7
44005,RI,Newport,44247,42165,2082,4.7
44007,RI,Providence,323291,305432,17859,5.5
44009,RI,Washington,68991,65718,3273,4.7
45001,SC,Abbeville,10272,9707,565,5.5
45003,SC,Aiken,74052,70333,3719,5
45005,SC,Allendale,2660,2431,229,8.6
45007,SC,Anderson,88808,84714,4094,4.6
45009,SC,Bamberg,5312,4830,482,9.1
45011,SC,Barnwell,8063,7466,597,7.4
45013,SC,Beaufort,72435,68957,3478,4.8
45015,SC,Berkeley,96894,92439,4455,4.6
45017,SC,Calhoun,6894,6466,428,6.2
45019,SC,Charleston,201534,193260,8274,4.1
45021,SC,Cherokee,23508,22098,1410,6
45023,SC,Chester,13378,12411,967,7.2
45025,SC,Chesterfield,21611,20528,1083,5
45027,SC,Clarendon,12707,11856,851,6.7
45029,SC,Colleton,16740,15798,942,5.6
45031,SC,Darlington,29879,28010,1869,6.3
45033,SC,Dillon,12673,11812,861,6.8
45035,SC,Dorchester,73092,69726,3366,4.6
45037,SC,Edgefield,10537,9937,600,5.7
45039,SC,Fairfield,9987,9263,724,7.2
45041,SC,Florence,65310,61854,3456,5.3
45043,SC,Georgetown,24941,23239,1702,6.8
45045,SC,Greenville,245243,234813,10430,4.3
45047,SC,Greenwood,31315,29688,1627,5.2
45049,SC,Hampton,8220,7738,482,5.9
45051,SC,Horry,140038,131823,8215,5.9
45053,SC,Jasper,11986,11461,525,4.4
45055,SC,Kershaw,29217,27685,1532,5.2
45057,SC,Lancaster,38304,36255,2049,5.3
45059,SC,Laurens,30003,28434,1569,5.2
45061,SC,Lee,6433,5976,457,7.1
45063,SC,Lexington,147910,141860,6050,4.1
45065,SC,McCormick,3390,3200,190,5.6
45067,SC,Marion,12670,11560,1110,8.8
45069,SC,Marlboro,9304,8518,786,8.4
45071,SC,Newberry,19170,18315,855,4.5
45073,SC,Oconee,34186,32415,1771,5.2
45075,SC,Orangeburg,35586,32413,3173,8.9
45077,SC,Pickens,56299,53486,2813,5
45079,SC,Richland,200219,190518,9701,4.8
45081,SC,Saluda,8886,8481,405,4.6
45083,SC,Spartanburg,142237,135490,6747,4.7
45085,SC,Sumter,44230,41619,2611,5.9
45087,SC,Union,11456,10742,714,6.2
45089,SC,Williamsburg,12464,11497,967,7.8
45091,SC,York,130517,124468,6049,4.6
46003,SD,Aurora,1521,1487,34,2.2
46005,SD,Beadle,9410,9168,242,2.6
46007,SD,Bennett,1123,1079,44,3.9
46009,SD,Bon Homme,2945,2865,80,2.7
46011,SD,Brookings,18884,18368,516,2.7
46013,SD,Brown,21087,20524,563,2.7
46015,SD,Brule,2471,2408,63,2.5
46017,SD,Buffalo,726,666,60,8.3
46019,SD,Butte,5047,4873,174,3.4
46021,SD,Campbell,850,825,25,2.9
46023,SD,Charles Mix,3888,3764,124,3.2
46025,SD,Clark,1920,1845,75,3.9
46027,SD,Clay,6986,6777,209,3
46029,SD,Codington,15204,14736,468,3.1
46031,SD,Corson,1453,1388,65,4.5
46033,SD,Custer,3993,3833,160,4
46035,SD,Davison,11235,10967,268,2.4
46037,SD,Day,2858,2737,121,4.2
46039,SD,Deuel,2239,2130,109,4.9
46041,SD,Dewey,2251,2049,202,9
46043,SD,Douglas,1671,1629,42,2.5
46045,SD,Edmunds,2163,2113,50,2.3
46047,SD,Fall River,3022,2890,132,4.4
46049,SD,Faulk,1113,1084,29,2.6
46051,SD,Grant,4457,4314,143,3.2
46053,SD,Gregory,2075,2013,62,3
46055,SD,Haakon,1105,1079,26,2.4
46057,SD,Hamlin,3173,3067,106,3.3
46059,SD,Hand,1831,1792,39,2.1
46061,SD,Hanson,1769,1709,60,3.4
46063,SD,Harding,761,739,22,2.9
46065,SD,Hughes,10062,9825,237,2.4
46067,SD,Hutchinson,3650,3557,93,2.5
46069,SD,Hyde,698,679,19,2.7
46071,SD,Jackson,1304,1250,54,4.1
46073,SD,Jerauld,1071,1045,26,2.4
46075,SD,Jones,569,556,13,2.3
46077,SD,Kingsbury,2740,2668,72,2.6
46079,SD,Lake,6456,6237,219,3.4
46081,SD,Lawrence,13060,12631,429,3.3
46083,SD,Lincoln,31436,30760,676,2.2
46085,SD,Lyman,1775,1692,83,4.7
46087,SD,McCook,3132,3055,77,2.5
46089,SD,McPherson,1088,1051,37,3.4
46091,SD,Marshall,2460,2365,95,3.9
46093,SD,Meade,13675,13246,429,3.1
46095,SD,Mellette,770,738,32,4.2
46097,SD,Miner,1200,1168,32,2.7
46099,SD,Minnehaha,107699,104942,2757,2.6
46101,SD,Moody,3950,3805,145,3.7
46102,SD,Oglala Lakota,3610,3223,387,10.7
46103,SD,Pennington,54703,53022,1681,3.1
46105,SD,Perkins,1577,1532,45,2.9
46107,SD,Potter,1157,1126,31,2.7
46109,SD,Roberts,4840,4640,200,4.1
46111,SD,Sanborn,1209,1173,36,3
46115,SD,Spink,3285,3184,101,3.1
46117,SD,Stanley,1870,1825,45,2.4
46119,SD,Sully,859,839,20,2.3
46121,SD,Todd,3059,2862,197,6.4
46123,SD,Tripp,3063,2995,68,2.2
46125,SD,Turner,4676,4546,130,2.8
46127,SD,Union,8048,7798,250,3.1
46129,SD,Walworth,2241,2126,115,5.1
46135,SD,Yankton,11582,11286,296,2.6
46137,SD,Ziebach,976,932,44,4.5
47001,TN,Anderson,33610,31980,1630,4.8
47003,TN,Bedford,19787,18808,979,4.9
47005,TN,Benton,6727,6249,478,7.1
47007,TN,Bledsoe,4314,4015,299,6.9
47009,TN,Blount,60728,58084,2644,4.4
47011,TN,Bradley,50035,47813,2222,4.4
47013,TN,Campbell,14706,13693,1013,6.9
47015,TN,Cannon,6009,5732,277,4.6
47017,TN,Carroll,12000,11196,804,6.7
47019,TN,Carter,23626,22296,1330,5.6
47021,TN,Cheatham,20223,19423,800,4
47023,TN,Chester,8430,8012,418,5
47025,TN,Claiborne,12674,11888,786,6.2
47027,TN,Clay,3036,2838,198,6.5
47029,TN,Cocke,14424,13516,908,6.3
47031,TN,Coffee,24408,23263,1145,4.7
47033,TN,Crockett,6874,6515,359,5.2
47035,TN,Cumberland,23517,22129,1388,5.9
47037,TN,Davidson,373277,359869,13408,3.6
47039,TN,Decatur,4652,4333,319,6.9
47041,TN,DeKalb,7534,7116,418,5.5
47043,TN,Dickson,24740,23666,1074,4.3
47045,TN,Dyer,16335,15326,1009,6.2
47047,TN,Fayette,18249,17333,916,5
47049,TN,Fentress,7094,6658,436,6.1
47051,TN,Franklin,19804,18846,958,4.8
47053,TN,Gibson,21198,19961,1237,5.8
47055,TN,Giles,15246,14635,611,4
47057,TN,Grainger,9268,8768,500,5.4
47059,TN,Greene,30817,29142,1675,5.4
47061,TN,Grundy,4780,4472,308,6.4
47063,TN,Hamblen,26801,25437,1364,5.1
47065,TN,Hamilton,171608,163729,7879,4.6
47067,TN,Hancock,2029,1869,160,7.9
47069,TN,Hardeman,9178,8615,563,6.1
47071,TN,Hardin,10187,9580,607,6
47073,TN,Hawkins,23666,22394,1272,5.4
47075,TN,Haywood,7662,7167,495,6.5
47077,TN,Henderson,11964,11149,815,6.8
47079,TN,Henry,13898,13082,816,5.9
47081,TN,Hickman,10417,9937,480,4.6
47083,TN,Houston,3192,2953,239,7.5
47085,TN,Humphreys,8627,8110,517,6
47087,TN,Jackson,4484,4172,312,7
47089,TN,Jefferson,23571,22331,1240,5.3
47091,TN,Johnson,7527,7167,360,4.8
47093,TN,Knox,233285,224002,9283,4
47095,TN,Lake,1912,1764,148,7.7
47097,TN,Lauderdale,9417,8692,725,7.7
47099,TN,Lawrence,17762,16742,1020,5.7
47101,TN,Lewis,4879,4590,289,5.9
47103,TN,Lincoln,15937,15287,650,4.1
47105,TN,Loudon,22242,21207,1035,4.7
47107,TN,McMinn,22721,21491,1230,5.4
47109,TN,McNairy,8749,8137,612,7
47111,TN,Macon,10219,9775,444,4.3
47113,TN,Madison,47714,45401,2313,4.8
47115,TN,Marion,11899,11153,746,6.3
47117,TN,Marshall,15048,14356,692,4.6
47119,TN,Maury,44013,42242,1771,4
47121,TN,Meigs,4889,4556,333,6.8
47123,TN,Monroe,19370,18351,1019,5.3
47125,TN,Montgomery,79827,75777,4050,5.1
47127,TN,Moore,3380,3253,127,3.8
47129,TN,Morgan,7790,7290,500,6.4
47131,TN,Obion,12547,11667,880,7
47133,TN,Overton,9199,8709,490,5.3
47135,TN,Perry,3184,2983,201,6.3
47137,TN,Pickett,2321,2169,152,6.5
47139,TN,Polk,7378,6956,422,5.7
47141,TN,Putnam,33199,31579,1620,4.9
47143,TN,Rhea,13450,12498,952,7.1
47145,TN,Roane,22820,21555,1265,5.5
47147,TN,Robertson,34696,33260,1436,4.1
47149,TN,Rutherford,163365,157344,6021,3.7
47151,TN,Scott,8008,7417,591,7.4
47153,TN,Sequatchie,5911,5567,344,5.8
47155,TN,Sevier,51117,48598,2519,4.9
47157,TN,Shelby,433440,410379,23061,5.3
47159,TN,Smith,8667,8271,396,4.6
47161,TN,Stewart,5158,4809,349,6.8
47163,TN,Sullivan,69645,66058,3587,5.2
47165,TN,Sumner,92179,88612,3567,3.9
47167,TN,Tipton,27459,25905,1554,5.7
47169,TN,Trousdale,3840,3655,185,4.8
47171,TN,Unicoi,6999,6504,495,7.1
47173,TN,Union,7267,6848,419,5.8
47175,TN,Van Buren,2033,1908,125,6.1
47177,TN,Warren,17641,16797,844,4.8
47179,TN,Washington,58640,55849,2791,4.8
47181,TN,Wayne,6077,5679,398,6.5
47183,TN,Weakley,15835,14913,922,5.8
47185,TN,White,11742,11160,582,5
47187,TN,Williamson,113370,109513,3857,3.4
47189,TN,Wilson,67716,65120,2596,3.8
48001,TX,Anderson,23520,22503,1017,4.3
48003,TX,Andrews,8694,8284,410,4.7
48005,TX,Angelina,37081,34894,2187,5.9
48007,TX,Aransas,10243,9671,572,5.6
48009,TX,Archer,4091,3914,177,4.3
48011,TX,Armstrong,934,908,26,2.8
48013,TX,Atascosa,21031,19909,1122,5.3
48015,TX,Austin,14036,13289,747,5.3
48017,TX,Bailey,2720,2601,119,4.4
48019,TX,Bandera,9508,9118,390,4.1
48021,TX,Bastrop,39048,37589,1459,3.7
48023,TX,Baylor,1606,1548,58,3.6
48025,TX,Bee,10314,9539,775,7.5
48027,TX,Bell,139567,133287,6280,4.5
48029,TX,Bexar,905907,872008,33899,3.7
48031,TX,Blanco,5937,5754,183,3.1
48033,TX,Borden,366,353,13,3.6
48035,TX,Bosque,8192,7840,352,4.3
48037,TX,Bowie,39644,37781,1863,4.7
48039,TX,Brazoria,169945,161140,8805,5.2
48041,TX,Brazos,111348,107501,3847,3.5
48043,TX,Brewster,3963,3814,149,3.8
48045,TX,Briscoe,548,524,24,4.4
48047,TX,Brooks,2440,2152,288,11.8
48049,TX,Brown,16178,15476,702,4.3
48051,TX,Burleson,7879,7514,365,4.6
48053,TX,Burnet,22006,21245,761,3.5
48055,TX,Caldwell,17951,17175,776,4.3
48057,TX,Calhoun,10780,10179,601,5.6
48059,TX,Callahan,5808,5561,247,4.3
48061,TX,Cameron,166103,154196,11907,7.2
48063,TX,Camp,5064,4718,346,6.8
48065,TX,Carson,3099,2998,101,3.3
48067,TX,Cass,12275,11393,882,7.2
48069,TX,Castro,3496,3389,107,3.1
48071,TX,Chambers,18221,17113,1108,6.1
48073,TX,Cherokee,21208,20132,1076,5.1
48075,TX,Childress,2962,2873,89,3
48077,TX,Clay,4798,4588,210,4.4
48079,TX,Cochran,1174,1115,59,5
48081,TX,Coke,1422,1363,59,4.1
48083,TX,Coleman,3066,2888,178,5.8
48085,TX,Collin,513282,495148,18134,3.5
48087,TX,Collingsworth,1216,1174,42,3.5
48089,TX,Colorado,9798,9337,461,4.7
48091,TX,Comal,65525,63157,2368,3.6
48093,TX,Comanche,5361,5130,231,4.3
48095,TX,Concho,1332,1287,45,3.4
48097,TX,Cooke,18924,18174,750,4
48099,TX,Coryell,24428,23289,1139,4.7
48101,TX,Cottle,525,498,27,5.1
48103,TX,Crane,1706,1560,146,8.6
48105,TX,Crockett,1737,1606,131,7.5
48107,TX,Crosby,2623,2508,115,4.4
48109,TX,Culberson,1000,959,41,4.1
48111,TX,Dallam,4002,3913,89,2.2
48113,TX,Dallas,1299195,1247033,52162,4
48115,TX,Dawson,4643,4410,233,5
48117,TX,Deaf Smith,8614,8345,269,3.1
48119,TX,Delta,2608,2509,99,3.8
48121,TX,Denton,452182,436692,15490,3.4
48123,TX,DeWitt,9504,8985,519,5.5
48125,TX,Dickens,692,658,34,4.9
48127,TX,Dimmit,6241,5797,444,7.1
48129,TX,Donley,1557,1494,63,4
48131,TX,Duval,4886,4353,533,10.9
48133,TX,Eastland,7424,7020,404,5.4
48135,TX,Ector,76244,71401,4843,6.4
48137,TX,Edwards,867,827,40,4.6
48139,TX,Ellis,85030,81849,3181,3.7
48141,TX,El Paso,349941,332660,17281,4.9
48143,TX,Erath,20241,19421,820,4.1
48145,TX,Falls,6613,6322,291,4.4
48147,TX,Fannin,15774,15181,593,3.8
48149,TX,Fayette,12497,12041,456,3.6
48151,TX,Fisher,1759,1684,75,4.3
48153,TX,Floyd,2738,2600,138,5
48155,TX,Foard,540,520,20,3.7
48157,TX,Fort Bend,367057,348745,18312,5
48159,TX,Franklin,4511,4291,220,4.9
48161,TX,Freestone,6871,6413,458,6.7
48163,TX,Frio,8784,8357,427,4.9
48165,TX,Gaines,9187,8845,342,3.7
48167,TX,Galveston,160181,151651,8530,5.3
48169,TX,Garza,2131,2048,83,3.9
48171,TX,Gillespie,13002,12633,369,2.8
48173,TX,Glasscock,749,720,29,3.9
48175,TX,Goliad,3319,3127,192,5.8
48177,TX,Gonzales,9574,9169,405,4.2
48179,TX,Gray,8489,7905,584,6.9
48181,TX,Grayson,61234,58878,2356,3.8
48183,TX,Gregg,58384,54836,3548,6.1
48185,TX,Grimes,11057,10327,730,6.6
48187,TX,Guadalupe,76000,73276,2724,3.6
48189,TX,Hale,12596,11889,707,5.6
48191,TX,Hall,1166,1088,78,6.7
48193,TX,Hamilton,3601,3425,176,4.9
48195,TX,Hansford,2947,2855,92,3.1
48197,TX,Hardeman,1625,1561,64,3.9
48199,TX,Hardin,25169,23640,1529,6.1
48201,TX,Harris,2251321,2131500,119821,5.3
48203,TX,Harrison,29961,28164,1797,6
48205,TX,Hartley,2961,2901,60,2
48207,TX,Haskell,2510,2404,106,4.2
48209,TX,Hays,104929,101434,3495,3.3
48211,TX,Hemphill,2116,2037,79,3.7
48213,TX,Henderson,35400,33747,1653,4.7
48215,TX,Hidalgo,337226,310913,26313,7.8
48217,TX,Hill,15812,15117,695,4.4
48219,TX,Hockley,11176,10658,518,4.6
48221,TX,Hood,25278,24091,1187,4.7
48223,TX,Hopkins,17332,16642,690,4
48225,TX,Houston,10068,9604,464,4.6
48227,TX,Howard,13218,12488,730,5.5
48229,TX,Hudspeth,1542,1450,92,6
48231,TX,Hunt,40534,38800,1734,4.3
48233,TX,Hutchinson,9639,9097,542,5.6
48235,TX,Irion,780,755,25,3.2
48237,TX,Jack,3856,3666,190,4.9
48239,TX,Jackson,7278,6938,340,4.7
48241,TX,Jasper,13471,12439,1032,7.7
48243,TX,Jeff Davis,1074,1042,32,3
48245,TX,Jefferson,107545,100017,7528,7
48247,TX,Jim Hogg,1945,1759,186,9.6
48249,TX,Jim Wells,17469,15628,1841,10.5
48251,TX,Johnson,76076,72766,3310,4.4
48253,TX,Jones,5627,5301,326,5.8
48255,TX,Karnes,6279,5973,306,4.9
48257,TX,Kaufman,57944,55752,2192,3.8
48259,TX,Kendall,20355,19705,650,3.2
48261,TX,Kenedy,218,208,10,4.6
48263,TX,Kent,470,456,14,3
48265,TX,Kerr,21368,20601,767,3.6
48267,TX,Kimble,1953,1879,74,3.8
48269,TX,King,178,171,7,3.9
48271,TX,Kinney,1157,1090,67,5.8
48273,TX,Kleberg,14115,13168,947,6.7
48275,TX,Knox,1560,1494,66,4.2
48277,TX,Lamar,23239,22165,1074,4.6
48279,TX,Lamb,5249,4909,340,6.5
48281,TX,Lampasas,9165,8785,380,4.1
48283,TX,La Salle,3888,3688,200,5.1
48285,TX,Lavaca,8745,8377,368,4.2
48287,TX,Lee,9288,8938,350,3.8
48289,TX,Leon,6513,6092,421,6.5
48291,TX,Liberty,31553,29181,2372,7.5
48293,TX,Limestone,8330,7864,466,5.6
48295,TX,Lipscomb,1652,1579,73,4.4
48297,TX,Live Oak,5206,4898,308,5.9
48299,TX,Llano,8296,7951,345,4.2
48301,TX,Loving,86,82,4,4.7
48303,TX,Lubbock,153638,148437,5201,3.4
48305,TX,Lynn,2731,2623,108,4
48307,TX,McCulloch,3711,3545,166,4.5
48309,TX,McLennan,116155,111567,4588,3.9
48311,TX,McMullen,862,844,18,2.1
48313,TX,Madison,4770,4528,242,5.1
48315,TX,Marion,4343,4039,304,7
48317,TX,Martin,2483,2374,109,4.4
48319,TX,Mason,1792,1727,65,3.6
48321,TX,Matagorda,16890,15656,1234,7.3
48323,TX,Maverick,24244,21523,2721,11.2
48325,TX,Medina,21000,20077,923,4.4
48327,TX,Menard,817,781,36,4.4
48329,TX,Midland,85085,81341,3744,4.4
48331,TX,Milam,10272,9743,529,5.1
48333,TX,Mills,1925,1845,80,4.2
48335,TX,Mitchell,2610,2427,183,7
48337,TX,Montague,9036,8589,447,4.9
48339,TX,Montgomery,266006,252985,13021,4.9
48341,TX,Moore,11198,10866,332,3
48343,TX,Morris,4895,4360,535,10.9
48345,TX,Motley,508,490,18,3.5
48347,TX,Nacogdoches,28723,27380,1343,4.7
48349,TX,Navarro,22778,21826,952,4.2
48351,TX,Newton,5355,4931,424,7.9
48353,TX,Nolan,6867,6538,329,4.8
48355,TX,Nueces,167828,158383,9445,5.6
48357,TX,Ochiltree,4664,4420,244,5.2
48359,TX,Oldham,909,882,27,3
48361,TX,Orange,37367,34865,2502,6.7
48363,TX,Palo Pinto,13257,12533,724,5.5
48365,TX,Panola,10234,9501,733,7.2
48367,TX,Parker,61299,58809,2490,4.1
48369,TX,Parmer,4950,4826,124,2.5
48371,TX,Pecos,6498,6117,381,5.9
48373,TX,Polk,17388,16290,1098,6.3
48375,TX,Potter,56183,54304,1879,3.3
48377,TX,Presidio,3080,2751,329,10.7
48379,TX,Rains,5557,5334,223,4
48381,TX,Randall,70691,68607,2084,2.9
48383,TX,Reagan,1702,1597,105,6.2
48385,TX,Real,1041,982,59,5.7
48387,TX,Red River,5035,4744,291,5.8
48389,TX,Reeves,6036,5716,320,5.3
48391,TX,Refugio,3138,2930,208,6.6
48393,TX,Roberts,442,422,20,4.5
48395,TX,Robertson,7259,6892,367,5.1
48397,TX,Rockwall,47370,45712,1658,3.5
48399,TX,Runnels,4650,4466,184,4
48401,TX,Rusk,22384,21080,1304,5.8
48403,TX,Sabine,3484,3158,326,9.4
48405,TX,San Augustine,2804,2554,250,8.9
48407,TX,San Jacinto,11431,10715,716,6.3
48409,TX,San Patricio,30623,28340,2283,7.5
48411,TX,San Saba,2449,2366,83,3.4
48413,TX,Schleicher,1421,1347,74,5.2
48415,TX,Scurry,7411,6975,436,5.9
48417,TX,Shackelford,1878,1806,72,3.8
48419,TX,Shelby,10959,10302,657,6
48421,TX,Sherman,1350,1311,39,2.9
48423,TX,Smith,105490,100724,4766,4.5
48425,TX,Somervell,4134,3935,199,4.8
48427,TX,Starr,26358,22841,3517,13.3
48429,TX,Stephens,4019,3807,212,5.3
48431,TX,Sterling,670,644,26,3.9
48433,TX,Stonewall,640,612,28,4.4
48435,TX,Sutton,1592,1465,127,8
48437,TX,Swisher,2717,2601,116,4.3
48439,TX,Tarrant,1011580,971375,40205,4
48441,TX,Taylor,63326,60960,2366,3.7
48443,TX,Terrell,406,390,16,3.9
48445,TX,Terry,5352,5097,255,4.8
48447,TX,Throckmorton,743,717,26,3.5
48449,TX,Titus,12883,12090,793,6.2
48451,TX,Tom Green,54275,51847,2428,4.5
48453,TX,Travis,678536,656988,21548,3.2
48455,TX,Trinity,5484,5151,333,6.1
48457,TX,Tyler,7216,6690,526,7.3
48459,TX,Upshur,17903,16757,1146,6.4
48461,TX,Upton,1582,1498,84,5.3
48463,TX,Uvalde,11813,11186,627,5.3
48465,TX,Val Verde,20147,18890,1257,6.2
48467,TX,Van Zandt,24865,23796,1069,4.3
48469,TX,Victoria,43733,41364,2369,5.4
48471,TX,Walker,23797,22551,1246,5.2
48473,TX,Waller,22180,20943,1237,5.6
48475,TX,Ward,5397,5090,307,5.7
48477,TX,Washington,15089,14323,766,5.1
48479,TX,Webb,113892,108333,5559,4.9
48481,TX,Wharton,21081,20022,1059,5
48483,TX,Wheeler,2483,2366,117,4.7
48485,TX,Wichita,55491,53081,2410,4.3
48487,TX,Wilbarger,5050,4813,237,4.7
48489,TX,Willacy,6504,5708,796,12.2
48491,TX,Williamson,278740,269396,9344,3.4
48493,TX,Wilson,23761,22834,927,3.9
48495,TX,Winkler,3071,2834,237,7.7
48497,TX,Wise,29439,28049,1390,4.7
48499,TX,Wood,17249,16342,907,5.3
48501,TX,Yoakum,3761,3582,179,4.8
48503,TX,Young,8312,7948,364,4.4
48505,TX,Zapata,5209,4649,560,10.8
48507,TX,Zavala,3887,3348,539,13.9
49001,UT,Beaver,3078,2926,152,4.9
49003,UT,Box Elder,24696,23835,861,3.5
49005,UT,Cache,61265,59396,1869,3.1
49007,UT,Carbon,8338,7843,495,5.9
49009,UT,Daggett,464,440,24,5.2
49011,UT,Davis,164429,159244,5185,3.2
49013,UT,Duchesne,8116,7396,720,8.9
49015,UT,Emery,4266,4000,266,6.2
49017,UT,Garfield,2796,2562,234,8.4
49019,UT,Grand,5729,5393,336,5.9
49021,UT,Iron,21478,20543,935,4.4
49023,UT,Juab,5221,5031,190,3.6
49025,UT,Kane,3695,3554,141,3.8
49027,UT,Millard,6215,6008,207,3.3
49029,UT,Morgan,5145,4992,153,3
49031,UT,Piute,458,431,27,5.9
49033,UT,Rich,1096,1061,35,3.2
49035,UT,Salt Lake,601889,582791,19098,3.2
49037,UT,San Juan,5745,5281,464,8.1
49039,UT,Sanpete,11804,11335,469,4
49041,UT,Sevier,9593,9173,420,4.4
49043,UT,Summit,23885,23134,751,3.1
49045,UT,Tooele,30841,29672,1169,3.8
49047,UT,Uintah,14138,12821,1317,9.3
49049,UT,Utah,279061,270441,8620,3.1
49051,UT,Wasatch,13909,13439,470,3.4
49053,UT,Washington,67287,64776,2511,3.7
49055,UT,Wayne,1428,1316,112,7.8
49057,UT,Weber,120177,115566,4611,3.8
50001,VT,Addison,20858,20238,620,3
50003,VT,Bennington,18451,17756,695,3.8
50005,VT,Caledonia,14907,14285,622,4.2
50007,VT,Chittenden,95242,92859,2383,2.5
50009,VT,Essex,2701,2566,135,5
50011,VT,Franklin,27364,26513,851,3.1
50013,VT,Grand Isle,3977,3828,149,3.7
50015,VT,Lamoille,13926,13334,592,4.3
50017,VT,Orange,15902,15407,495,3.1
50019,VT,Orleans,13541,12829,712,5.3
50021,VT,Rutland,31467,30278,1189,3.8
50023,VT,Washington,33910,32827,1083,3.2
50025,VT,Windham,23225,22451,774,3.3
50027,VT,Windsor,29337,28475,862,2.9
51001,VA,Accomack,15781,15002,779,4.9
51003,VA,Albemarle,54377,52428,1949,3.6
51005,VA,Alleghany,6924,6568,356,5.1
51007,VA,Amelia,6190,5924,266,4.3
51009,VA,Amherst,14970,14308,662,4.4
51011,VA,Appomattox,6988,6658,330,4.7
51013,VA,Arlington,146165,142305,3860,2.6
51015,VA,Augusta,36792,35432,1360,3.7
51017,VA,Bath,2491,2398,93,3.7
51019,VA,Bedford,37910,36346,1564,4.1
51021,VA,Bland,2736,2591,145,5.3
51023,VA,Botetourt,17325,16690,635,3.7
51025,VA,Brunswick,6202,5830,372,6
51027,VA,Buchanan,6853,6112,741,10.8
51029,VA,Buckingham,6258,5916,342,5.5
51031,VA,Campbell,25904,24744,1160,4.5
51033,VA,Caroline,14838,14169,669,4.5
51035,VA,Carroll,12945,12273,672,5.2
51036,VA,Charles City,3715,3544,171,4.6
51037,VA,Charlotte,5246,4980,266,5.1
51041,VA,Chesterfield,180468,173432,7036,3.9
51043,VA,Clarke,7424,7156,268,3.6
51045,VA,Craig,2347,2234,113,4.8
51047,VA,Culpeper,23415,22498,917,3.9
51049,VA,Cumberland,4597,4383,214,4.7
51051,VA,Dickenson,4570,4112,458,10
51053,VA,Dinwiddie,13427,12766,661,4.9
51057,VA,Essex,5517,5247,270,4.9
51059,VA,Fairfax,615850,595783,20067,3.3
51061,VA,Fauquier,35872,34611,1261,3.5
51063,VA,Floyd,8178,7842,336,4.1
51065,VA,Fluvanna,13162,12715,447,3.4
51067,VA,Franklin,26331,25190,1141,4.3
51069,VA,Frederick,45273,43673,1600,3.5
51071,VA,Giles,7931,7501,430,5.4
51073,VA,Gloucester,19063,18359,704,3.7
51075,VA,Goochland,10814,10402,412,3.8
51077,VA,Grayson,7013,6651,362,5.2
51079,VA,Greene,9917,9589,328,3.3
51081,VA,Greensville,4202,3987,215,5.1
51083,VA,Halifax,14846,13971,875,5.9
51085,VA,Hanover,57089,55067,2022,3.5
51087,VA,Henrico,178588,171556,7032,3.9
51089,VA,Henry,22113,20865,1248,5.6
51091,VA,Highland,1305,1264,41,3.1
51093,VA,Isle of Wight,18904,18081,823,4.4
51095,VA,James City,34812,33450,1362,3.9
51097,VA,King and Queen,3655,3501,154,4.2
51099,VA,King George,12302,11771,531,4.3
51101,VA,King William,8737,8402,335,3.8
51103,VA,Lancaster,5103,4813,290,5.7
51105,VA,Lee,8434,7855,579,6.9
51107,VA,Loudoun,206982,200302,6680,3.2
51109,VA,Louisa,18542,17826,716,3.9
51111,VA,Lunenburg,5245,5001,244,4.7
51113,VA,Madison,7162,6936,226,3.2
51115,VA,Mathews,4033,3870,163,4
51117,VA,Mecklenburg,12445,11738,707,5.7
51119,VA,Middlesex,5020,4826,194,3.9
51121,VA,Montgomery,49659,47584,2075,4.2
51125,VA,Nelson,7225,6962,263,3.6
51127,VA,New Kent,11655,11256,399,3.4
51131,VA,Northampton,5869,5525,344,5.9
51133,VA,Northumberland,5442,5142,300,5.5
51135,VA,Nottoway,7025,6742,283,4
51137,VA,Orange,16340,15669,671,4.1
51139,VA,Page,11579,10929,650,5.6
51141,VA,Patrick,7942,7553,389,4.9
51143,VA,Pittsylvania,29658,28234,1424,4.8
51145,VA,Powhatan,13617,13129,488,3.6
51147,VA,Prince Edward,10141,9595,546,5.4
51149,VA,Prince George,14911,14179,732,4.9
51153,VA,Prince William,234613,225972,8641,3.7
51155,VA,Pulaski,16250,15272,978,6
51157,VA,Rappahannock,3706,3574,132,3.6
51159,VA,Richmond,3903,3757,146,3.7
51161,VA,Roanoke,49064,47292,1772,3.6
51163,VA,Rockbridge,10447,9986,461,4.4
51165,VA,Rockingham,40499,39061,1438,3.6
51167,VA,Russell,11230,10497,733,6.5
51169,VA,Scott,9412,8947,465,4.9
51171,VA,Shenandoah,20798,20007,791,3.8
51173,VA,Smyth,13659,12859,800,5.9
51175,VA,Southampton,9023,8665,358,4
51177,VA,Spotsylvania,64850,62172,2678,4.1
51179,VA,Stafford,68194,65495,2699,4
51181,VA,Surry,3652,3458,194,5.3
51183,VA,Sussex,3943,3693,250,6.3
51185,VA,Tazewell,15937,14730,1207,7.6
51187,VA,Warren,19671,18867,804,4.1
51191,VA,Washington,26810,25588,1222,4.6
51193,VA,Westmoreland,8966,8551,415,4.6
51195,VA,Wise,13191,12062,1129,8.6
51197,VA,Wythe,13641,12855,786,5.8
51199,VA,York,32065,30807,1258,3.9
51510,VA,Alexandria city,96239,93414,2825,2.9
51520,VA,Bristol city,7438,7057,381,5.1
51530,VA,Buena Vista city,3271,3103,168,5.1
51540,VA,Charlottesville city,24842,23995,847,3.4
51550,VA,Chesapeake city,117771,112686,5085,4.3
51570,VA,Colonial Heights city,8700,8306,394,4.5
51580,VA,Covington city,2379,2238,141,5.9
51590,VA,Danville city,19083,17914,1169,6.1
51595,VA,Emporia city,2242,2096,146,6.5
51600,VA,Fairfax city,12953,12553,400,3.1
51610,VA,Falls Church city,7968,7748,220,2.8
51620,VA,Franklin city,3533,3316,217,6.1
51630,VA,Fredericksburg city,13541,12886,655,4.8
51640,VA,Galax city,2898,2753,145,5
51650,VA,Hampton city,63883,60204,3679,5.8
51660,VA,Harrisonburg city,24197,23017,1180,4.9
51670,VA,Hopewell city,9765,9121,644,6.6
51678,VA,Lexington city,2262,2122,140,6.2
51680,VA,Lynchburg city,35471,33608,1863,5.3
51683,VA,Manassas city,21563,20777,786,3.6
51685,VA,Manassas Park city,8468,8156,312,3.7
51690,VA,Martinsville city,5156,4788,368,7.1
51700,VA,Newport News city,88716,84126,4590,5.2
51710,VA,Norfolk city,110200,104318,5882,5.3
51720,VA,Norton city,1659,1544,115,6.9
51730,VA,Petersburg city,13191,12147,1044,7.9
51735,VA,Poquoson city,6158,5940,218,3.5
51740,VA,Portsmouth city,44009,41276,2733,6.2
51750,VA,Radford city,8247,7796,451,5.5
51760,VA,Richmond city,114503,109125,5378,4.7
51770,VA,Roanoke city,48866,46742,2124,4.3
51775,VA,Salem city,12873,12361,512,4
51790,VA,Staunton city,11775,11310,465,3.9
51800,VA,Suffolk city,42903,40871,2032,4.7
51810,VA,Virginia Beach city,228884,219722,9162,4
51820,VA,Waynesboro city,10177,9750,427,4.2
51830,VA,Williamsburg city,6704,6329,375,5.6
51840,VA,Winchester city,14304,13726,578,4
53001,WA,Adams,8711,8150,561,6.4
53003,WA,Asotin,9956,9462,494,5
53005,WA,Benton,94235,88317,5918,6.3
53007,WA,Chelan,43265,40797,2468,5.7
53009,WA,Clallam,27298,25231,2067,7.6
53011,WA,Clark,220633,207286,13347,6
53013,WA,Columbia,1717,1606,111,6.5
53015,WA,Cowlitz,44818,41623,3195,7.1
53017,WA,Douglas,20526,19116,1410,6.9
53019,WA,Ferry,2491,2235,256,10.3
53021,WA,Franklin,39829,36877,2952,7.4
53023,WA,Garfield,919,866,53,5.8
53025,WA,Grant,44550,41379,3171,7.1
53027,WA,Grays Harbor,27224,24965,2259,8.3
53029,WA,Island,32715,30794,1921,5.9
53031,WA,Jefferson,11500,10691,809,7
53033,WA,King,1211626,1163875,47751,3.9
53035,WA,Kitsap,118087,111546,6541,5.5
53037,WA,Kittitas,21520,20243,1277,5.9
53039,WA,Klickitat,9638,8984,654,6.8
53041,WA,Lewis,31899,29420,2479,7.8
53043,WA,Lincoln,4888,4616,272,5.6
53045,WA,Mason,23489,21723,1766,7.5
53047,WA,Okanogan,21396,19977,1419,6.6
53049,WA,Pacific,8285,7621,664,8
53051,WA,Pend Oreille,4658,4244,414,8.9
53053,WA,Pierce,404347,380137,24210,6
53055,WA,San Juan,7870,7503,367,4.7
53057,WA,Skagit,57929,54172,3757,6.5
53059,WA,Skamania,5070,4720,350,6.9
53061,WA,Snohomish,414786,396826,17960,4.3
53063,WA,Spokane,234348,220149,14199,6.1
53065,WA,Stevens,17876,16410,1466,8.2
53067,WA,Thurston,129691,122413,7278,5.6
53069,WA,Wahkiakum,1288,1177,111,8.6
53071,WA,Walla Walla,28695,27149,1546,5.4
53073,WA,Whatcom,107044,100841,6203,5.8
53075,WA,Whitman,23091,21940,1151,5
53077,WA,Yakima,125788,116297,9491,7.5
54001,WV,Barbour,6963,6489,474,6.8
54003,WV,Berkeley,54111,51966,2145,4
54005,WV,Boone,7992,7264,728,9.1
54007,WV,Braxton,5494,5012,482,8.8
54009,WV,Brooke,9984,9280,704,7.1
54011,WV,Cabell,41232,39247,1985,4.8
54013,WV,Calhoun,2623,2286,337,12.8
54015,WV,Clay,3260,2922,338,10.4
54017,WV,Doddridge,3783,3587,196,5.2
54019,WV,Fayette,15980,14712,1268,7.9
54021,WV,Gilmer,2541,2331,210,8.3
54023,WV,Grant,5958,5604,354,5.9
54025,WV,Greenbrier,15692,14844,848,5.4
54027,WV,Hampshire,9900,9469,431,4.4
54029,WV,Hancock,12863,11962,901,7
54031,WV,Hardy,5720,5394,326,5.7
54033,WV,Harrison,32361,30471,1890,5.8
54035,WV,Jackson,12010,11231,779,6.5
54037,WV,Jefferson,28569,27607,962,3.4
54039,WV,Kanawha,85335,80673,4662,5.5
54041,WV,Lewis,6831,6250,581,8.5
54043,WV,Lincoln,7293,6670,623,8.5
54045,WV,Logan,11163,10024,1139,10.2
54047,WV,McDowell,5085,4467,618,12.2
54049,WV,Marion,25682,24002,1680,6.5
54051,WV,Marshall,14072,12950,1122,8
54053,WV,Mason,10035,9319,716,7.1
54055,WV,Mercer,21697,20245,1452,6.7
54057,WV,Mineral,11914,11204,710,6
54059,WV,Mingo,6731,5882,849,12.6
54061,WV,Monongalia,51304,49084,2220,4.3
54063,WV,Monroe,5981,5709,272,4.5
54065,WV,Morgan,7658,7322,336,4.4
54067,WV,Nicholas,9591,8745,846,8.8
54069,WV,Ohio,20637,19492,1145,5.5
54071,WV,Pendleton,3656,3514,142,3.9
54073,WV,Pleasants,2955,2713,242,8.2
54075,WV,Pocahontas,3728,3480,248,6.7
54077,WV,Preston,14859,14005,854,5.7
54079,WV,Putnam,25786,24526,1260,4.9
54081,WV,Raleigh,29947,27853,2094,7
54083,WV,Randolph,12211,11480,731,6
54085,WV,Ritchie,4566,4267,299,6.5
54087,WV,Roane,5204,4668,536,10.3
54089,WV,Summers,4572,4292,280,6.1
54091,WV,Taylor,7822,7381,441,5.6
54093,WV,Tucker,3477,3289,188,5.4
54095,WV,Tyler,3549,3233,316,8.9
54097,WV,Upshur,9810,9070,740,7.5
54099,WV,Wayne,15538,14512,1026,6.6
54101,WV,Webster,3491,3200,291,8.3
54103,WV,Wetzel,7205,6539,666,9.2
54105,WV,Wirt,2232,2036,196,8.8
54107,WV,Wood,36836,34720,2116,5.7
54109,WV,Wyoming,7423,6666,757,10.2
55001,WI,Adams,8299,7799,500,6
55003,WI,Ashland,7971,7539,432,5.4
55005,WI,Barron,24401,23291,1110,4.5
55007,WI,Bayfield,7551,7030,521,6.9
55009,WI,Brown,141443,136333,5110,3.6
55011,WI,Buffalo,6586,6292,294,4.5
55013,WI,Burnett,7192,6760,432,6
55015,WI,Calumet,27773,26883,890,3.2
55017,WI,Chippewa,33430,32008,1422,4.3
55019,WI,Clark,17567,16881,686,3.9
55021,WI,Columbia,31638,30499,1139,3.6
55023,WI,Crawford,7939,7551,388,4.9
55025,WI,Dane,318384,309310,9074,2.9
55027,WI,Dodge,47965,46217,1748,3.6
55029,WI,Door,15540,14769,771,5
55031,WI,Douglas,23618,22380,1238,5.2
55033,WI,Dunn,24374,23379,995,4.1
55035,WI,Eau Claire,58996,56984,2012,3.4
55037,WI,Florence,2233,2101,132,5.9
55039,WI,Fond du Lac,57047,55042,2005,3.5
55041,WI,Forest,4008,3759,249,6.2
55043,WI,Grant,28261,27157,1104,3.9
55045,WI,Green,21251,20544,707,3.3
55047,WI,Green Lake,9783,9305,478,4.9
55049,WI,Iowa,13726,13245,481,3.5
55051,WI,Iron,2644,2447,197,7.5
55053,WI,Jackson,10349,9896,453,4.4
55055,WI,Jefferson,45797,44017,1780,3.9
55057,WI,Juneau,13566,12965,601,4.4
55059,WI,Kenosha,88690,84565,4125,4.7
55061,WI,Kewaunee,11057,10651,406,3.7
55063,WI,La Crosse,67699,65258,2441,3.6
55065,WI,Lafayette,9864,9550,314,3.2
55067,WI,Langlade,9596,9098,498,5.2
55069,WI,Lincoln,15293,14625,668,4.4
55071,WI,Manitowoc,41933,40128,1805,4.3
55073,WI,Marathon,73771,71151,2620,3.6
55075,WI,Marinette,20277,19166,1111,5.5
55077,WI,Marquette,7570,7185,385,5.1
55078,WI,Menominee,1578,1458,120,7.6
55079,WI,Milwaukee,477610,453900,23710,5
55081,WI,Monroe,23075,22193,882,3.8
55083,WI,Oconto,20510,19601,909,4.4
55085,WI,Oneida,18629,17721,908,4.9
55087,WI,Outagamie,104081,100418,3663,3.5
55089,WI,Ozaukee,49144,47506,1638,3.3
55091,WI,Pepin,4176,4017,159,3.8
55093,WI,Pierce,24734,23734,1000,4
55095,WI,Polk,24933,23791,1142,4.6
55097,WI,Portage,39574,38064,1510,3.8
55099,WI,Price,6897,6601,296,4.3
55101,WI,Racine,99941,95020,4921,4.9
55103,WI,Richland,9284,8935,349,3.8
55105,WI,Rock,84290,80583,3707,4.4
55107,WI,Rusk,7018,6660,358,5.1
55109,WI,St. Croix,49769,47895,1874,3.8
55111,WI,Sauk,35308,34049,1259,3.6
55113,WI,Sawyer,7937,7441,496,6.2
55115,WI,Shawano,21339,20453,886,4.2
55117,WI,Sheboygan,61857,59760,2097,3.4
55119,WI,Taylor,11103,10645,458,4.1
55121,WI,Trempealeau,16700,16084,616,3.7
55123,WI,Vernon,15793,15216,577,3.7
55125,WI,Vilas,9998,9430,568,5.7
55127,WI,Walworth,57824,55517,2307,4
55129,WI,Washburn,7993,7595,398,5
55131,WI,Washington,77359,74774,2585,3.3
55133,WI,Waukesha,225291,217528,7763,3.4
55135,WI,Waupaca,27028,25962,1066,3.9
55137,WI,Waushara,11506,10927,579,5
55139,WI,Winnebago,93262,89943,3319,3.6
55141,WI,Wood,34692,33054,1638,4.7
56001,WY,Albany,20988,20315,673,3.2
56003,WY,Big Horn,5544,5268,276,5
56005,WY,Campbell,24427,22667,1760,7.2
56007,WY,Carbon,8369,7976,393,4.7
56009,WY,Converse,7883,7391,492,6.2
56011,WY,Crook,3742,3570,172,4.6
56013,WY,Fremont,20051,18607,1444,7.2
56015,WY,Goshen,7034,6790,244,3.5
56017,WY,Hot Springs,2427,2310,117,4.8
56019,WY,Johnson,4211,3985,226,5.4
56021,WY,Laramie,48836,46805,2031,4.2
56023,WY,Lincoln,8731,8320,411,4.7
56025,WY,Natrona,41038,38106,2932,7.1
56027,WY,Niobrara,1339,1295,44,3.3
56029,WY,Park,15943,15188,755,4.7
56031,WY,Platte,4778,4548,230,4.8
56033,WY,Sheridan,16139,15377,762,4.7
56035,WY,Sublette,4235,3962,273,6.4
56037,WY,Sweetwater,22154,20811,1343,6.1
56039,WY,Teton,15257,14729,528,3.5
56041,WY,Uinta,9433,8884,549,5.8
56043,WY,Washakie,4217,4016,201,4.8
56045,WY,Weston,3962,3764,198,5
72001,PR,Adjuntas Municipio,4465,3714,751,16.8
72003,PR,Aguada Municipio,11898,10238,1660,14
72005,PR,Aguadilla Municipio,14895,12681,2214,14.9
72007,PR,Aguas Buenas Municipio,6781,5810,971,14.3
72009,PR,Aibonito Municipio,6668,5676,992,14.9
72011,PR,Anasco Municipio,8886,7744,1142,12.9
72013,PR,Arecibo Municipio,23978,20818,3160,13.2
72015,PR,Arroyo Municipio,5136,4184,952,18.5
72017,PR,Barceloneta Municipio,5857,5030,827,14.1
72019,PR,Barranquitas Municipio,7475,6517,958,12.8
72021,PR,Bayamon Municipio,66306,60358,5948,9
72023,PR,Cabo Rojo Municipio,14156,12396,1760,12.4
72025,PR,Caguas Municipio,48226,43251,4975,10.3
72027,PR,Camuy Municipio,9497,8324,1173,12.4
72029,PR,Canovanas Municipio,16261,14394,1867,11.5
72031,PR,Carolina Municipio,62118,56753,5365,8.6
72033,PR,Catano Municipio,7906,7114,792,10
72035,PR,Cayey Municipio,16207,14470,1737,10.7
72037,PR,Ceiba Municipio,3795,3299,496,13.1
72039,PR,Ciales Municipio,3836,3218,618,16.1
72041,PR,Cidra Municipio,15568,13976,1592,10.2
72043,PR,Coamo Municipio,10859,8897,1962,18.1
72045,PR,Comerio Municipio,5067,4385,682,13.5
72047,PR,Corozal Municipio,9242,8108,1134,12.3
72049,PR,Culebra Municipio,895,865,30,3.4
72051,PR,Dorado Municipio,12915,11874,1041,8.1
72053,PR,Fajardo Municipio,11276,9721,1555,13.8
72054,PR,Florida Municipio,3367,2880,487,14.5
72055,PR,Guanica Municipio,4138,3392,746,18
72057,PR,Guayama Municipio,12041,10069,1972,16.4
72059,PR,Guayanilla Municipio,5288,4299,989,18.7
72061,PR,Guaynabo Municipio,37162,34951,2211,5.9
72063,PR,Gurabo Municipio,17500,16015,1485,8.5
72065,PR,Hatillo Municipio,13312,11245,2067,15.5
72067,PR,Hormigueros Municipio,5617,4930,687,12.2
72069,PR,Humacao Municipio,17452,14993,2459,14.1
72071,PR,Isabela Municipio,12602,10827,1775,14.1
72073,PR,Jayuya Municipio,4218,3673,545,12.9
72075,PR,Juana Diaz Municipio,15584,13329,2255,14.5
72077,PR,Juncos Municipio,12451,10809,1642,13.2
72079,PR,Lajas Municipio,5627,4577,1050,18.7
72081,PR,Lares Municipio,7405,5976,1429,19.3
72083,PR,Las Marias Municipio,2862,2437,425,14.8
72085,PR,Las Piedras Municipio,11357,9829,1528,13.5
72087,PR,Loiza Municipio,8647,7669,978,11.3
72089,PR,Luquillo Municipio,6329,5431,898,14.2
72091,PR,Manati Municipio,11639,10288,1351,11.6
72093,PR,Maricao Municipio,1953,1656,297,15.2
72095,PR,Maunabo Municipio,3018,2465,553,18.3
72097,PR,Mayaguez Municipio,23206,20025,3181,13.7
72099,PR,Moca Municipio,10736,9067,1669,15.5
72101,PR,Morovis Municipio,8113,7023,1090,13.4
72103,PR,Naguabo Municipio,8081,7085,996,12.3
72105,PR,Naranjito Municipio,7255,6315,940,13
72107,PR,Orocovis Municipio,5199,4394,805,15.5
72109,PR,Patillas Municipio,4810,3818,992,20.6
72111,PR,Penuelas Municipio,6116,5096,1020,16.7
72113,PR,Ponce Municipio,47774,41369,6405,13.4
72115,PR,Quebradillas Municipio,6075,5106,969,16
72117,PR,Rincon Municipio,4627,3905,722,15.6
72119,PR,Rio Grande Municipio,17081,15292,1789,10.5
72121,PR,Sabana Grande Municipio,6440,5420,1020,15.8
72123,PR,Salinas Municipio,7561,5924,1637,21.7
72125,PR,San German Municipio,10348,8769,1579,15.3
72127,PR,San Juan Municipio,135057,124410,10647,7.9
72129,PR,San Lorenzo Municipio,11900,10411,1489,12.5
72131,PR,San Sebastian Municipio,10712,8688,2024,18.9
72133,PR,Santa Isabel Municipio,9889,8238,1651,16.7
72135,PR,Toa Alta Municipio,26531,24327,2204,8.3
72137,PR,Toa Baja Municipio,29730,27052,2678,9
72139,PR,Trujillo Alto Municipio,27107,25157,1950,7.2
72141,PR,Utuado Municipio,6879,5813,1066,15.5
72143,PR,Vega Alta Municipio,9870,8734,1136,11.5
72145,PR,Vega Baja Municipio,13722,11821,1901,13.9
72147,PR,Vieques Municipio,3257,2912,345,10.6
72149,PR,Villalba Municipio,7808,6231,1577,20.2
72151,PR,Yabucoa Municipio,9073,7540,1533,16.9
72153,PR,Yauco Municipio,10726,8713,2013,18.8
